אֵב	ev
אַבָּא	aba
אָבֹב	avov
אֲבַגְתָא	avagta
אָבַד	avad
אָבֵד	aved
אִבֵּד	ibed
אֲבֵדָה	aveda
אֲבַדּוֹן	avadon
אָבְדָּן	ovdan
אָבְדָּנִי	ovdani
אָבָה	ava
אָבוּד	avud
אִבּוּד	ibud
אֵבוּז	evuz
אֲבוֹי	avoy
אִבּוּל	ibul
אֶבוֹלוּצְיָה	evolutzya
אִבּוּלִים	ibulim
אֵבוּס	evus
אֲבוּקָה	avuka
אָבוֹת	avot
אֲבוֹתֵיכֶם	avotechem
אַבְזָקָא	avzaka
אַבְזָקָה	avzaka
אַבְזָקַת	avzakat
אַבְזָר	avzar
אִבְזֵר	ivzer
אֻבְזַר	uvzar
אִבְחָה	ivkha
אִבְחוּן	ivkhun
אִבְחֵן	ivkhen
אֻבְחַן	uvkhan
אֶבְטַח	evtakh
אִבְטֵחַ	iveakh
אִבְטֵחַ	ivteakh
אֻבְטַח	uvtakh
אֲבַטִּיחַ	avatiakh
אַבְטִיחַ	avtiakh
אֲבַטִּיחִים	avatikhim
אַב־טִיפּוּס	av tipus
אַבְטָלָה	avtala
אָבִי	avi
אֲבִי	avi
אָבִי	avi
אָבִיב	aviv
אָבִּיגָ'אן	abidjan
אֲבִיגַיִל	avigayil
אֲבִיהֶן	avihen
אֲבִי הָעֶזְרִי	avi haezri
אֲבִיּוֹנָה	aviyona
אָבִיךְ	avich
אָבִיךָ	avicha
אַבִּיר	abir
אַבִּירִים	abirim
אֲבִישָׁלוֹם	avishalom
אֹבֶךְ	ovekh
אָבַל	aval
אֲבָל	aval
אֶבֶן	even
אַבְנֵט	avnet
אַבְנֵטִים	avnetim
אַבְנָן	avnan
אַבְנֵר	avner
אָבַס	abas
אַבְּסוּרְד	absurd
אֲבַעְבּוּעָה	avabua
אֲבַעְבּוּעוֹת רוּחַ	avabuot ruakh
אָבָץ	avatz
אָבָק	avak
אֶבֶק	evek
אַבְקָה	avka
אַבְקָן	avkan
אָבַר	avar
אֵבֶר	ever
אַבְרָהָם	avraham
אַבְרָם	avram
אַבְשָׁלוֹם	avshalom
אֲבֹתֵיכֶם	avotechem
אֲבֹתָם	avotam
אַגַּב	agav
אַגָּדָה	aggadah
אֲגֻדָּה	aguda
אֲגֻדַּת	agudat
אֲגוּדָל	agudal
אֱגוֹז	egoz
אֱגוֹז אֲדָמָה	egoz adama
אֲגוֹרָה	agora
אֲגַם	agam
אַגַּן יַם תִּיכוֹן	agan yam tichon
אַגָּס	agas
אַגָּסִים	agasim
אָגַר	agar
אֶגְרוֹל	egrol
אֶגרוֹף	egrof
אִגְרוּף	igruf
אִגְרוּף תַּיְלַנְדִּי	igruf tailandi
אִגֶּרֶת חוֹב	igeret khov
אֵד	ed
אֱדוֹם	edom
אָדוֹן	adon
אֲדוֹנֵי	adone
אֲדוֹנִי	adoni
אַדִּיר	addir
אֲדִישׁוּת	adishut
אדלשטיין	edelshtein
אָדָם	adam
אָדֹם	adom
אָדֹם	adom
אֹדֶם	odem
אֲדַמְדַּם	adamdam
אֲדָמָה	adama
אַדְמַת	admat
אֶדֶן	eden
אֲדֹנָי	adonai
אֲדֹנָי	adonay
אֲדֹנָי	athonoy
אֲדָר	adar
אֵדֶר	eder
אֶדֶר	eder
אַדְּרַבָּא	adraba
אַדְּרַבָּה	adraba
אַדְרִיכָל	adrikhal
אַדְרִיכָלוּת	adrikhalut
אַדֶּרֶת	aderet
אָדַשׁ	adash
אָהַב	ahav
אַהֲבָה	ahava
אָהוּב	ahuv
אֶהְיֶה	ehye
אָהַל	ahal
אָהָל	ahal
אִהֵל	ihel
אֹהֶל	ohel
אַהֲרֹן	aharon
אוֹ	o
אוֹבְּיֶקְטִיבִי	obyektivi
אוֹבָלִי	ovali
אוֹגוּסְט	ogust
אוֹגֵר	oger
אוּד	ud
אִוָּה	iva
אוֹהֵב	ohev
אוֹהָיוֹ	ohayo
אַוָּז	avaz
אוּזְבֶּקִית	uzbekit
אֲוָזוֹן	avazon
אוֹחַ	oakh
אוֹטוֹ	oto
אוֹטוֹבּוּס	otobus
אוֹטוֹבּוּסִים	otobusim
אוּטוֹפְּיָה	utopiya
אוֹטִיזְם	otizm
אוֹיֵב	oyev
אוֹי וַאֲבוֹי	oy vaavoy
אֲוִיר	avir
אֲוִירָה	avira
אֲוִירוֹן	aviron
אוֹכֵל‏	okhel
אוּלַי	ulai
אוֹלִיגַרְךְ	oligarkh
אוֹלִימְפִּי	olimpi
אוּלָם	ulam
אוֹמֵן	omen
אוֹמֵר	omer
אוֹמְרִים	omrim
אוֹן	on
אוּנִיבֶרְסִיטָה	universita
אוֹנֵן	onen
אוֹנֵנה	onena
אוֹנָנוּת	onanut
אוננים	unanim
אוּנֶסכּ״וֹ	unesko
אוֹסְטְרָלִי	ostrali
אוֹסְטְרַלְיָה	ostralya
אוֹסְטְרָלִית	ostralit
אוֹפָה	ofa
אוֹפֶה	ofe
אוֹפּוֹזִיצְיָה	opozitsya
אוֹפְּטִימָלִי	optimali
אוֹפַן	ofan
אוֹפַנּוֹעַ	ofanoa
אוֹפַנּוֹעִים	ofanoim
אוֹפַנַּיִם	ofanayim
אוֹפַנִּים	ofanim
אוֹפּצִיָה	optzia
אוּץ	uts
אוֹצִיא	otsi
אוֹצָר	otsar
אוֹצֵר	otser
אוֹצְרוֹת	otsrot
אוֹקְטוֹבֶּר	oktober
אוֹקֵי	okey
אוֹקְיָנוֹס	oqyanos
אוֹקְיָנוֹס הַקֶּרַח הַצְּפוֹנִי	okyanos hakerakh hatsfoni
אוּקְרָאִינָה	ukraina
אוֹר	or
אוֹרְגַּזְמָה	orgazma
אוֹרְגַּזְמוֹת	orgazmot
אוֹרֶגָנוֹ	oregano
אוֹרְגָּנִי	organi
אוֹרְגָּנִיזְם	organizm
אוֹרְגָּנִיזַצְיָה	organizatzya
אוֹרָה	ora
אוֹרוֹן	oron
אוֹרֵז	orez
אוֹרֵחַ	oreakh
אוֹרִי	ori
אוּרִי	uri
אוֹרִיגָמִי	origami
אוּרִיָּה	uriya
אוּרָנוּס	uranus
אוּרַנְיוּם	uranyum
אוֹת	ot
אוֹתָהּ	otah
אוֹתוֹ	oto
אוֹתוֹת	otot
אוֹתִי	oti
אוֹתִיּוֹת	otiyot
אוֹתְךָ	otkha
אוֹתֶנְטִי	otenti
אוֹתֵת	otet
אָז	az
אֵזוֹר	ezor
אִזְכֵּר	izker
אֻזְכַּר	uzkar
אָזַל	azal
אָזְלַת יָד	azlat yad
אִזְמֵל	izmel
אֹזֶן	ozen
אַזְעָקָה	azaka
אֶזְרָח	ezrakh
אֶזְרָחוּת	ezrakhut
אֶזְרָחִי	ezrakhi
אָח	akh
אָח	akh
אֶחָד	ekhad
אִחֵד	ikhed
אֻחַד	ukhad
אַחַד עָשָׂר	akhad asar
אַחֲוָה	akhava
אָחוּז	akhuz
אֲחוּזִים	akhuzim
אִחוּר	ikhur
אָחוֹת	akhot
אָחַז	akhaz
אָחָז	akhaz
אַחְזָקָה	akhzaka
אֲחִי	akhi
אָחִי	akhi
אָחִיו	achiv
אֶחָיו	echav
אֲחָיוֹת	akhayot
אחייניות	akhyaniyot
אַחִים	akhayim
אַחְיָן	akhyan
אַחְיָנִית	akhyanit
אַחְלָמָה	akhlama
אַחַר	achar
אחר	achar
אַחֵר	acher
אִחֵר	icher
אַחֲרוֹן	acharon
אַחֵרוֹת	akherot
אַחֲרַי	akharay
אַחֲרֵי	akhare
אַחֲרָיוּת	akharayut
אַחֵרִים	akherim
אַחַר כָּךְ	akhar kakh
אַחַר־כָּךְ	akhar-kakh
אַחֶרֶת	acheret
אֲחַשְׁוֵרוֹשׁ	akhashverosh
אַחַת	akhat
אֲחֹתוֹ	achoto
אַחַת עֶשְׂרֵה	akhat esre
אַט	at
אַט אַט	at at
אָטוֹם	atom
אָטוּם	atum
אָטוֹמִי	atomi
אֵטִימוֹלוֹגְיָה	etimologya
אֵטִימוֹלוֹגְיוֹת	etimologyot
אִטְלִיז	itliz
אַטְמוֹסְפֶרָה	atmosfera
אִטְרִיָּה	itriya
־ַאי	-ai-ai-ay
אֵי	e
אִי	i
־אִי	-iy
אֵיבָר	eivar
אִידֵאָל	ideal
אִידִישׁ	idish
אִידִישָׁאִי	idisai
אַיָּה	aya
אַיָּה	aya
אַיֵּה	aye
אַיּוֹ	ayo
אִיּוֹב	iyov
אי־ודאות	i-vadaut
אִיּוּם	iyum
אִיזֶבֶל	izevel
אֵיזֶה	eize
אֵיזוֹ	eizo
אִיחוּד	ikhud
אִיטַלְיָה	italiya
אִיטַלְקִי	italki
אִיטַלְקִית	italkit
אִיִּים	iyim
אֵיךְ	eykh
אֵיכָה	eikha
אֵיכוּת	eikhut
אִיכְתִּיּוֹלוֹגְיָה	ikhtiyolohiya
אַיָּל	ayal
אַיִל	ayil
אֱיָל	eyal
אֱיָל	eyal
אֵילוּ	eylu
אֵילִים	elim
אִילָן	ilan
אִילָנוֹת	ilanot
אִילָנֵי	ilane
אֵילַת	eilat
אָיֹם	ayom
אִיֵּם	iyem
אִימוּנוֹלוֹגְיָה	imunologia
אֵימָתַי	eimatay
אַיִן	ayin
אֵין	ein
אֵין בְּעַד מָה	ein bad ma
אֵין דָּבָר הָעוֹמֵד בִּפְנֵי הָרָצוֹן	ein davar haomed bfnei haratzon
אֵין דִּין וְאֵין דַּיָּן	ein din vein dayan
אֵין דִּין וְאֵין דַּיָּן	ein din vein dayan
אֵין מַצָּב	en matsav
אֵין עָשָׁן בְּלִי אֵשׁ	ein ashan bli esh
אִינְדּוֹנֶזְיָה	indonezya
אִינְדּוֹנֶזִית	indonezit
אֵינָהּ	einah
אֵינוֹ	eino
אִי נוֹחוּת	i-nokhut
אִינְטֶלִיגֶנְטִי	inteligenti
אִינְטֶלִיגֶנְצְיָה	inteligentsya
אִינְטֶלִיגֶנְצְיָה מְלָאכוּתִית	inteligentsya melakhutit
אִינְטֶרְנֶט	internet
אֵינֵךְ	einekh
אֵינְךָ	einkha
אֵינָם	einam
אֵינָן	einan
אֵינְסוֹף	einsof
אֵינְסוֹפִי	einsofi
אִינְפוֹרְמַצְיָה	informatsya
אִינְפְלַצְיָה	inflatsya
אֵיפָה	eifa
אֵיפֹה	eifo
אִיָּר	iyar
אִירָאן	iran
אִירָאנִי	irani
אֵירוֹפָּה	eiropa
אִישׁ	ish
אִישׁוֹן	ishon
אִישּׁוּר	ishur
אִישִׁי	ishi
אִישִׁיּוּת	ishiyut
אִיֵּת	iyet
אֻיַּת	uyat
אֵיתָן	etan
אַךְ	akh
אַכַּד	akad
אַכַּדִּי	akadi
אַכַּדִּית	akadit
אִכְזֵב	ikhzev
אַכְזָבָה	akhzava
אַכְזָרִי	achzari
אָכַל	akhal
אִכֵּל	ikel
אֹכֶל	okhel
אֻכַּל	ukal
אֻכָּל	ukal
אָכְלָה	okhla
אֻכְלוּסִין	ukhlusin
אַל	al
אֵל	el
אֶל	el
אֶלָּא	ela
אָלְבּוּם	album
אָלְבּוּמִים	albumim
אַלְבָּנִי	albani
אַלְבַּנְיָה	albanya
אַלְבָּנִית	albanit
אֵלָה	ela
אֵלָה	ela
אֵלֶּה	ele
אֱלֹהַי	elohai
אֱלֹהֵיך	eloheykh
אֱלֹהֵיכֵם	eloheykhem
אֱלֹהִים	elohim
אֱלֹהֵינוּ	eloheynu
אֲלֵהֶם	alehem
אֵלָו	elav
אֵלּוּ	elu
אִלּוּ	ilu
אֱלוֹהַּ	eloah
אֱלוּל	elul
אָלוּמִינְיוּם	aluminyum
אַלּוֹן	alon
אַלּוּנְקָה	alunka
אַלּוּף	aluf
אִלּוּץ	iluts
אַלְטֶע זַאכֶן	alte zakhen
אֵלַי	elay
אֱלֵי	ele
אֱלִי	eli
אֵלִי	eli
אֻלַי	ulay
אֵלֶיהָ	eleha
אֵלִיָּהוּ	eliyahu
אֲלֵיהֶם	alehem
אֲלֵיהֶן	alehen
אֵלָיו	elav
אֵלַיִךְ	elayikh
אֲלֵיכֶם	alechem
אַלִּימוּת	alimut
אֱלִיעֶזֶר	eliezer
אֱלִישֶׁבַע	elisheva
אֵלֵךְ	elech
אֵלְכָה	elchaattention
אַלְכּוֹהוֹל	alkohol
אַלְכִּימְיָה	alkimia
אִלֵּם	ilem
אֻלָם	ulam
אַלְמוֹג	almog
אַלְמָן	alman
אַלְמָנָה	almana
אַלְמָנוֹת	almanot
אַלְמְנוּת	almnut
אֶלְעָד	elad
אֶלְעָזָר	elazar
אָלֶ״ף	alef
אָלֶף	alef
אֶלֶף	elef
אִלֵּף	ilef
אַלְפָא	alfa
אָלֶפְבֵּית	alefbet
אֲלָפִים	alafim
אֻלְפָּן	ulpan
אֶלֶקְטְרוֹן	elektron
אֱלֹקִים	elokim
אַל־רֵיחַ	al-reakh
אִלְתּוּר	iltur
אֵם	em
אִם	im
אֵם קְרִיאָה	em kria
אִמָּא	imma
אָמַד	amad
אַמָּה	ama
אָמָה	ama
אִמָּה	ima
אֻמָּה	uma
אַמְהָרִית	amharit
אִמּוֹ	imo
אֵמוּן	emun
אֱמוּנָה	emuna
אֱמוּנוֹת	emunot
אֱמוּנָתְךָ	emunatkha
אִמּוּץ	imuts
אָמוֹק	amok
אָמוֹרָא	amora
אֲמִירָה	amira
אָמֵן	amen
אָמָּן	oman
אֻמַּן	uman
אֻמָּן	uman
אַמְנוֹן	amnon
אַמְנוּן	amnun
אָמָּנוּת	omanut
אֻמָּנוּת	umanut
אָמָּנוּת הַבָּמָה	omanut habama
אָמָּנוּת מוֹדֶרְנִית	omanut modernit
אָמָּנוּת עַכְשָׁוִית	omanut akhshavit
אֱמֻנַת	emunat
אַמְסְטֶרְדָּם	amsterdam
אַמְפֶּר	amper
אָ‏מְפֵּ‏רְסָ‏נְד	ampersand
אֶמְפַּתְיָה	empatia
אִמֵּץ	imets
אֹמֶץ	omets
אֻמַּץ	umats
אָמַר	amar
אִמֵּר	imer
אֹמֶר	omer
אָמֶרִיקָאִי	amerikai
אָמֶרִיקָאִית	amerikait
אָמֶרִיקָה	amerika
אָמֶרִיקָנִי	amerikani
אָמֶרִיקָנִית	amerikanit
אֶמֶשׁ	emesh
אֱמֶת	emet
אֲמִתִּי	amiti
אָנָּא	ana
אָנָאלִי	anali
אַנְגְּלִי	angli
אַנְגְּלִיָּה	angliya
אַנְגְּלִית	anglit
אָנָּה	ana
אָנָה	ana
אָנוּ	anu
אָנוֹכִי	anokhi
אָנוֹכִיּוּת	anochiyut
אָנוֹנִימִי	anonimi
אָנוּס	anus
אָנוּס	anus
אִנּוּס	inus
אָנוּשׁ	anush
אֱנוֹשׁ	enosh
אֱנוֹשׁוּת	enoshut
אֱנוֹשִׁי	enosh
אֶנְזִים	enziym
אֲנַחְנוּ	anakhnu
אֶנְטוֹמוֹלוֹגְיָה	entomologya
אַנְטִי־	anti-
אַנְטִיבְּיוֹטִיקָה	antibyotika
אַנְטִישֵׁמִי	antishemi
אַנְטֶנָה	antena
אַנְטְרֶקוֹט	antrekot
אֲנִי	ani
אֳנִיָּה	oniya
אֲנִי לֹא מְדַבֵּר אַנְגְּלִית	ani lo medaber anglit
אֲנִי לֹא מְדַבֵּר עִבְרִית	ani lo medaber ivrit
אֲנִי לֹא מְדַבֶּרֶת אַנְגְּלִית	ani lo medaberet anglit
אֲנִי לֹא מְדַבֶּרֶת עִבְרִית	ani lo medaberet ivrit
אֲנִי־עֶלְיוֹן	ani-elyon
אני צריך להזמין מונית	ani tsarikh lehazmin monit
אני צריך מפה	ani tsarikh mapa m
אני צריך מפה של העיר	ani tsarikh mapa shel hair m
אני צריכה מפה	ani tsrikha mapa f
אני צריכה מפה של העיר	ani tsrikha mapa shel hair f
אָנֹכִי	anochi
אָנֹכִי	anokhi
אנ׳לא	anlo
אָנָנָס	ananas
אַנָּס	anas
אָנַס	anas
אֹנֶס	ones
אֶנְצִיקְלוֹפֶּדְיָה	entsiklopedya
אֶנְצִיקְלוֹפֶּדְיוֹת	entsiklopedyot
אַנְשֵׁי	anshe
אֲנָשִׁים	anashim
אָסָא	asa
אָסוֹן	ason
אָסוּר	asur
אִסּוּר	isur
אֶסְטוֹנְיָה	estonya
אֶסְטוֹנִית	estonit
אַסְטְרוֹנוֹמְיָה	astronomya
אַסְטְרוֹפִיזִיקָה	astrofiziqa
אַסְטְרָטֶגְיָה	astrategiya
אַסְיָה	asya
אָסִימְפְּטוֹטָה	asimptota
אָסִיר	asir
אִסְלָאם	islam
אסלאם סוני	islam suni
אסלאם שיעי	islam shii
אִסְלָאמִי	islami
אַסְלָה	asla
אָסַף	asaf
אֹסֶף	osef
אֹסֶף	osef
אֲסֵפָה	asefa
אֶסְפָהָאן	esfahan
אַסְפִּירִין	aspirin
אֶסְפֶּרַנְטוֹ	esperanto
אָסְרָה	asra
אָסֻרָה	asura
אֱסָרָהּ	esarah
אֶסְתֵּר	ester
אַעֲלֶה	aale
אֶעֱלֶה	eele
אֶעֱשֶׂה	eese
אַף	af
אַף־עַל־פִּי	af al pi
אָפָה	afa
אפ׳חד	afkhad
אֶפְחַד	efkhad
אַפִּיפְיוֹר	apifyor
אֲפִיקוֹמָן	afikoman
אֲפִלּוּ	afilu
אַפְּלִיקַצְיָה	aplikatsya
אֹפֶן	ofen
אָפְנָה	ofna
אֶפֶס	efes
אָפָּצִ׳י	apachi
אַפְּצִ׳י	apchi
אֹפֶק	ofek
אָפְקִי	ofki
אָפְקִיּוּת	ofkiyut
אָפֹר	afor
אֵפֶר	efer
אֶפְרוֹחַ	efroakh
אַפְּרִיל	april
אֶפְרַיִם	efrayim
אַפְרִיקָה	afrika
אפרסקים	afarsekim
אֲפַרְפַּר	afarpar
אֶפְרָת	efrat
אֶפְשַׁר	efshar
אִפְשֵׁר	ifsher
אָפַּתְיָה	apatia
אָץ	ats
אֶצְבַּע	etsba
אֶצְבַּעוֹת	etzbaot
אַצָּה	atsa
אִצְטַדְיוֹן	itstadyon
אָצִיל	atsil
אַצִּיל	atzil
אֵצֶל	etsel
אֲצֻלָּה	atsula
אֶצְלוֹ	etslo
אֶצְלֵךְ	etzlekh
אֶצְלְךָ	etzlkha
אֶקְדָּח	ekdakh
אָקָדֶמְיָה	akademya
אֶקוֹלוֹגִי	ekologi
אֶקוֹלוֹגְיָה	ekologya
אָקוֹרְד	akord
אַקְלִים	aklim
אַקְסֵסוֹרִי	aksesori
אַקְשִׁיב	akshiv
אַרְאֶה	are
אֵרָאֶה	erae
אֶרְאֶה	ere
אָרַב	arav
אַרְבָּה	arba
אַרְבֶּה	arbe
אַרְבַּע	arba
אַרְבָּעָה	arbaa
אַרְבָּעִים	arbaim
אַרְבַּע עֶשְׂרֵה	arba esre
אַרְגּוֹן	argon
אִרְגּוּן	irgun
אַרְגָּמָן	argaman
אֲרוּחָה	arukha
אֲרוּחוֹת	aruchot
ארוחת ערב	arukhat erev
אָרוֹן	aron
אֲרוֹנוֹת	aronot
אָרוּס	arus
אֶרוֹס	eros
אֵרוּעַ	erua
אָרוּר	arur
אָרַז	araz
אֶרֶז	erez
אֹרֶז	orez
אֹרַח	orakh
אַרְטִישׁוֹק	artishoq
אֲרִי	ari
אֲרִיאֵל	ariel
אַרְיֵה	arye
אֲרָיוֹת	arayot
אָרִיקָה	arika
אָרֹךְ	arokh
אֹרֶךְ	orekh
אֹרֶךְ גַּל	orekh gal
אַרְכִיּוֹן	arkhion
אַרְכִיטֶקְטוּרָה	arkhitektura
אַרְכִיפֶּלָג	arkhipelag
אָרַכְנוֹפוֹבְּיָה	arakhnofobya
אֲרַם	aram
אַרְמוֹן	armon
אֲרַמִּי	arami
אֲרָמִית	aramit
אַרְמֶנִי	armeni
אַרְמֶנְיָה	armenya
ארמניות	armeniyot
אַרְמֶנִית	armenit
אֹרֶן	oren
אַרְנָב	arnav
אַרְנָק	arnak
אֶרֶס	eres
אֶרֶץ	eretz
אָרֻצָה	arutsa
אֶרְצֶה	ertse
אֲרָצוֹת	aratzot
אַרְצוֹת הַבְּרִית	artsot habrit
אַרְצִי	artsi
אָרַר	arar
אֵשׁ	esh
אַשְׁדּוֹד	ashdod
אִשָּׁה	isha
אִשָּׁה	ishah
אָשׁוּבָה	ashuva
אַשּׁוּר	ashur
אֶשֶׁךְ	eshekh
אֶשְׁכּוֹלִיוֹת	eshkoliot
אֶשְׁכּוֹלִית	eshkolit
אֶשְׁכֵּיִים	eshkhayim
אֲשָׁכִים	ashakhim
אַשְׁכְּנַזִּי	ashkenazi
אַשְׁלְגָן	ashlegan
אֶשְׁלָחֲךָ	eshlachacha
אַשְׁלָיָה	ashlaya
אַשְׁמָה	ashma
אֶשְׁמַע	eshma
אֶשְׁמֹר	eshmor
אַשְׁמֹרֶת	ashmoret
אַשְׁקְלוֹן	ashklon
אֲשֶׁר	asher
אָשֵׁר	asher
אִשֵּׁר	isher
אֹשֶׁר	osher
אֻשַּׁר	ushar
אַשְׁרַאי	ashrai
אֲשֵׁרָה	ashera
אַשְׁרָה	ashra
אִשְׁרֵר	ishrer
אֵשֶׁת	eshet
אֵשֶׁת אִישׁ	eshet ish
אִשְׁתּוֹ	ishto
אשתיק	ashtik
אֶשְׁתָּקַד	eshtakad
אַתְּ	at
אֵת	et
אֹת	ot
אַתֶּאִיְזם	ateizm
אֵת, אֶת־	et, et-
אֶתְגָּר	etgar
אַתָּה	ata
אִתָּהּ	itah
אִתּוֹ	ito
אֹתוֹ	oto
אָתוֹן	aton
אֲתוֹנוֹת	atonot
אֹתוֹת	otot
אִתִּי	iti
אֶתְכֶם	etchem
אִתְּכֶם	itchem
אִתְּכֶם	itkhem
אִתְּכֶן	itkhen
אֲתֶּם	atem
אִתָּם	itam
אֶתְמוֹל	etmol
אַתֶּן	aten
אֶתֵּן	eten
אִתָּנוּ	itanu
אֶתְפַּשֵּׁט	etpashet
אֶתְרוֹג	etrog
אֶתְרוֹגִים	etrogim
אֹתֹת	otot
בְּ־	b-
בָּא	ba
בֹּא	bo
בָּאג	bag
בָּאָה	baa
בָּאָה	baa
בֹּאָהּ	boah
בָּאוּ	bau
בָּאוּלִינְגּ	bauling
בָּאִים	baim
בָּא לְ־	ba le-
בֶּאֱמֶת	beemet
בָּאסָה	basa
בָּא עַל הֶחָתוּם	ba al hekhatum
בֵּאֵר	beer
בְּאֵר	ber
בְּאֵר שֶׁבַע	ber sheva
בֻּבָּה	buba
בָּבֶל	bavel
בָּבְלִי	bavli
בַּג	bag
בָּגַד	bagad
בֶּגֶד	beged
בגד ים	beged yam
בְּגָדִים	bgadim
בָּגֶט	baget
בִּגְלַל	biglal
בִּגְלַל שֶׁ־	biglal she-
בג״ץ	b.g.ts.
בַּגְרוּת	bagrut
בַּד	bad
בַּד	bad
בָּדָד	badad
בֻּדַּד	budad
בָּדָה	bada
בִּדֵּחַ	bideakh
בַּדְחָן	badkhan
בִּדְיוֹן	bidyon
בְּדִיּוּק	bdiyuk
בְּדִיחָה	bdikha
בְּדִיחוֹת	bdichot
בְּדִיעֲבַד	bediavad
בְּדִיקָה	bdika
בָּדַל	badal
בְּדָל	bdal
בִּדֵּל	bidel
בְּדֹלַח	bdolakh
בַּדְלָנוּת	badlanut
בָּדַק	badak
בָּהָאִי	bahai
בָּהִיר	bahir
בְּהִירָה	behira
בְּהִירוּת	bhirut
בְּהֶכְרֵחַ	bhekhreakh
‎‎בָּהֶם	bahem
בְּהֵמָה	behema
בְּהֵמוֹת	behemot
בְּהַצְלָחָה	bhatzlakha
בְּהָקִיץ	bhaqits
בּוֹ	bo
בּוֹא	bo
בּוֹגוֹטָה	bogota
בּוֹדַד	bodad
בּוֹדֵד	boded
בּוֹלֵט	bolet
בּוּל עֵץ	bul ets
בּוּמֶרַנְג	bumerang
בוֹנוּס	bonus
בּוֹסְפּוֹרוּס	bosporus
בּוּעָה	bua
בּוֹקֵר	boker
בּוּקָרֶשְׂט	bukarest
בּוֹר	bor
בּוּר	bur
בוּר	bur
בּוֹרְבּוֹן	borbon
בּוֹר מַיִם	bor mayim
בּוּרְסָה	bursa
בּוּרֶקָס	burekas
בַּז	baz
בָּז	baz
בִּזְבֵּז	bizbez
בִּזְהִירוּת	bizhirut
בִּזְכוּת	bizkhut
בַּזֶּלֶת	bazelet
בָּחוּר	bakhur
בַּחוּרָה	bakhura
בְּחִילָה	bchila
בְּחִינָה	bkhina
בְּחִירָה	bkhira
בְּחִירוֹת	bkhirot
בְּחֶמְלָה	bkhemlah
בָּחַר	bakhar
בִּטֵּא	bite
בֻּטָּא	buta
בָּטוּחַ	batuakh
בִּטּוּחַ	bituakh
בִּטּוּי	bitui
בָּטַח	batakh
בֶּטַח	betakh
בִּטָּחוֹן	bitakhon
בִּטָּחוֹן עַצְמִי	bitakhon atzmi
בִּטְחוֹנִי	bitkhoni
בָּטָטָה	batata
בָּטַל	batal
בָּטֵל	batel
בִּטֵּל	bitel
בֻּטַּל	butal
בֶּטֶן	beten
בֹּטֶן	boten
בִּי	bi
בֵּיְגֶּל	beigel
בֵּיְגָּלֶה	beigale
בִּיג מֶק	big mek
בִּיג מֶקִים	big mekim
בִּידוּד	bidud
בִּיוֹ־	biyo- , bio-
בִּיוֹטֶכְנוֹלוֹגְיָה	biotekhnologya
ביוטכנולוגיות	biotekhnologyot
ביוטכנולוגית	biotekhnologyat
בִּיוֹלוֹג	biolog
בִּיוֹלוֹגְיָה	biologia
בִּיּוֹמֶטְרִיָּה	biyometriya
בִּיּוֹמַסָּה	biyomasa
בְּיַחַד	byakhad
בִּיט	bit
בִּימָה	bima
בֵּין	bein
בִּינָה	bina
בִּינָה מְלָאכוּתִית	bina melakhutit
בִּינַת	binat
בֵּינְתַיִם	beintayim, beinatayim
בֵּיצָה	betza
בֵּיצִים	beytsim
בֵּיצֵפָר	beitsefer
בִּירָה	bira
בִּירָה	bira
בַּיְשָׁן	bayshan
בַּיִת	bayit
בֵּי״ת	beyt
בֵּית	beyt
בִּיֵּת	biyet
בֻּיַּת	buyat
בֵּיתָא	beta
בֵּית דִּין	bet din
בַּיְתָה	bayta
בֵּיתָה	beta
בֵּיתָהּ	betah
בֵּיתוֹ	beto
בֵּית־חוֹלִים	beit-kholim
בֵּית חֲרֹשֶׁת	beit-kharoshet
בֵּית־כְּנֶסֶת	beit-kneset
בֵּית לֶחֶם	bet lekhem
בית מלון	beit malon
בֵיתֵנוּ	beitenu
בֵּית סֵפֶר	bet sefer
בֵּית־קָפֶה	beit-kafe
בֵּית שֶׁמֶשׁ	beyt shemesh
בָּכָה	bakha
בִּכָּה	bika
בְּכַוָּנָה	bkhavana
בְּכוֹר	bkhor
בֶּכִי	bekhi
בַּכְיָן	bakhyan
בְּכָל אֹפֶן	bkhol ofen
בְּכָל זֹאת	bkhol zot
בִּכְלָל	bikhlal
בֶּכֶר	bekher
בִּכֵּר	biker
בְּכֹר	bkhor
בַּכְרִי	bachri
בִּכְרִי	bichri
בְּכֹרֶךָ	bchorecha
בְּלֹא	blo
בֵּלָארוּס	belarus
בִּלְבּוּל	bilbul
בִּלְבֵּל	bilbel
בֶּלְגְּיָה	belgya
בָּלָגָן	balagan
בָּלָה	bala
בִּלָּה	bila
בִּלְהָה	bilha
בְּלוֹג	blog
בַּלּוּט	balut
בַּלּוּטָה	baluta
בָּלוּי	baluy
בִּלּוּי	biluy
בָּלוֹן	balon
בָּלֵט	balet
בְּלִי	bli
בְּלִילָה	blila
בָּלַל	balal
בָּלַע	bala
בִּלֵּעַ	bilea
בַּלְקָנִי	balkani
בַּלָּשׁ	balash
בַּלְשָׁן	balshan
בִּלְשָׁן	bilshan
בַּלְשָׁנוּת	balshanut
בִּלְתִּי	bilti
‎בָּם	bam
בַּמַּאי	bamay
בַּמְבּוּק	bambuk
בָּמָה	bama
בִּמְהִירוּת	bimhirut
בִּמְהֵרָה	bimhera
בְּמוֹ יָדָיו	bmo yadav
בַּמָּקוֹם	bamakom
בִּמְקוֹם	bimqom
בְּמֶשֶׁךְ	bmeshekh
‎‎בָּן	ban
בָּן	ban
בֵּן	ben
בֶּן־זוֹנָה	ben-zona
בֶּן יִשְׂרָאֵל	ben yisrael
בֵּן פּוֹרָת יוֹסֵף	ben porat yosef
בֶּן תַּרְבּוּת	ben tarbut
בֶּן־תַּרְבּוּת	ben tarbut
בַּנַּאי	banai
בָּנָאלִי	banali
בְּנִגּוּד לְ־	bnigud l-
בַּנְגְּלָדֶשׁ	bangladesh
בָּנָה	bana
בְּנָהּ	bnah
בַּנּוּ	banu
בָּנוּ	banu
בָּנוּ	banu
בְּנוֹ	bno
בְּנוּ	bnu
בָּנוֹת	banot
בֶּנזִין	benzin
בֶּנֶט	benet
בְּנֵי בְּרַק	bnei brak
בָּנָיו	banav
בְּנֵי יִשְׂרָאֵל	bne yisrael
בְּנֵיכֶם	bnechem
בָּנִים	banim
בִּנְיָמִין	binyamin
בְּנֵי מִצְוָה	bne mitsva
בִּנְיָן	binyan
בָּנָנָה	banana
בָּנָנוֹת	bananot
בַּנְק	bank
בַּנְק דָּם	bank-dam
בַּנְק מֶרְכָּזִי	bank merkazi
בְּנֹתָיו	bnotav
בְּנֹתֵיכֶם	bnotechem
בְּסֵדֶר	bseder
בְּסֵדֶר גָּמוּר	bseder gamur
בָּסִיס	basis
בְּסִיסֵי־	bsisei-
בְּסִיסִי	bsisi
בְּעַד	bad
בְּעוֹד מוֹעֵד	bod moed
בָּעַט	baat
בְּעָיָה	beaya
בְּעִיטָה	bita
בְּעָיָתִי	baayati
בַּעַל	baal
בַּעַל	baal
בָּעַל	baal
בַּעַל דִּין	baal din
בַּעַל זְבוּב	baal zvuv
בַּעַל חַיִּים	baal khayim
בְּעָלִים	balim
בְּעֶצֶם־	betzem-
בְּעֶצֶם	betzem
בַּעֲקִיפִין	baakifin
בְּעִקָּר	bikar
בַּעַר	baar
בָּעַר	baar
בִּעֵר	bier
בְּעֹר	bor
בִּפְנִים	bifnim
בִּצָּה	bitza
בָּצָל	batsal
בָּצֵק	batsek
בָּצֵק פָּרִיךְ	batsek parikh
בַּקְבּוּק	bakbuk
בִּקְבֵּק	bikbek
בַּקְטֶרְיוֹלוֹגְיָה	bacteriologya
בָּקָר	baqar
בִּקֵּר	biqqer
בֹּקֶר	boker
בֹּקֶר	boqer
בְּקָרוֹב	bkarov
בֹּקֶר טוֹב	boker tov
בְּקָרִים	bkarim
בִּקֹּרֶת	biqoret
בַּקְּרַת אַקְלִים	bakarat aklim
בִּקֵּשׁ	bikesh
בַּקָּשָׁה	bakasha
בַּקְּשׁוֹת־	bakshot-
בַּקָּשׁוֹת	bkakashot
בַּקָּשַׁת־	bakashat
בִּקַּשְׁתְּ	bikasht
בִּקַּשְׁתָּ	bikashta
בַּר	bar
בָּר	bar
בָּר	bar
בָּרָא	bara
בֵּרֵא	bere
בַּרְבּוּר	barbur
בֹּרֶג	boreg
בָּרָד	barad
בַּרְדְּלָס	bardlas
בַּרְוָז	barvaz
בַּרְוָז	barvaz
בַּרְוָזוֹן	barvazon
בְּרוּחַ הַזְּמַן	bruach hazman
בָּרוּךְ	barukh
בָּרוּךְ הַבָּא	barukh haba
בְּרוּכִים הַבָּאִים	bruchim habaim
בְּרוֹקוֹלִי	brokoli
בָּרוּר	barur
בֶּרֶז	berez
בְּרָזִיל	brazil
ברזים	brazim
בַּרְזֶל	barzel
בָּרַח	barach
בָּרִיא	bari
בְּרִיאָה	bria
בְּרִיאוּת	briut
בְּרִיאוּתִי	briuti
בְּרִיחַ	briakh
בְּרִיטַנְיָה	britanya
בֶּרִילְיוּם	berilyum
בְּרִית	brit
בְּרִיתוֹ	brito
בָּרַךְ	barakh
בֶּרֶךְ	berekh
בֵּרֵךְ	berekh  berakh
בֵּרֵךְ	berekh, berakh
בֹּרַךְ	borakh
בֹּרַךְ	borakh
בְּרָכָה	brakha
בְּרֵכָה	brekha
בְּרָכָה אַחֲרוֹנָה	brakha akharona
בְּרָכָה רִאשׁוֹנָה	brakha rishona
בִּרְכּוֹן	birkon
בִּרְכוֹת	birkhot
בְּרָכוֹת	brakhot
בִּרְכַּיִים	birkayim
בִּרְכַּת	birkat
בֶּרְלִין	berlin
בְּרַם	bram
בַּר מִינַן	bar minan
בַּרְמֶן	barmen
בֶּרמַן	berman
בַּר מִצְוָה	bar mitsva
בָּרָק	barak
בְּרֶקְזִיט	brekzit
בְּרָקִים	brakim
בְּרֵרָה	brera
בֹּשׁ	bosh
בִּשְׁבִיל	bishvil
בִּשְׁבִילִי	bishvili
בְּשוּם אוֹפֶן	bshum ofen
בִּשֵּׁל	bishel
בְּשֶׁל	bshel
בשלושה דברים אדם ניכר: בכוסו, בכיסו, ובכעסו.	bishlosha dvarim adam nikar bkhoso, bkhiso, uvkhaaso.
בֹּשֶׂם	bosem
בָּשָׂר	basar
בִּשֵּׂר	biser
בָּשָׂר לָבָן	basar lavan
בַּת	bat
בְּתֵאָבוֹן	bteavon
בִּתּוֹ	bito
בְּתוֹךְ	btokh
בָּתוּל	batul
בְּתוּלָה	betula
בְּתוּלוֹת	btulot
בְּתוּלַת	btulat
בָּתֵּי־כְּנֶסֶת	bate-kneset
בָּתִּים	batim
בַּת יָם	bat yam
בַּת שֶׁבַע	bat sheva
גֵּאֶה	gee
גַּאֲוָה	gaava
גֵּאוֹמֶטְרְיָה	geometrya
גָּאוֹן	gaon
גָּאַל	gaal
גְּאֻלָּה	gula
גַּב	gav
גֵּב	gev
גַּבַּאי	gabai
גַּבָּה	gaba
גָּבָה	gava
גָּבַהּ	gavah
גָּבֹהַּ	gavoah
ג־ב־הּ	g-b-h
גִּבָּה	giba
גֹּבַהּ	govah
גְּבוּל	gvul
גְּבוּלוֹת	gvulot
גִּבּוֹר	gibor
גְּבִינָה	gvina
גְּבִינוֹת	gvinot
גָּבִיעַ	gavia
גָּבִישׁ	gavish
גָּבַל	gaval
גְּבַל	gval
גִּבְעָה	giva
גִּבְעוֹל	givol
גִּבְעָתַיִם‎	givatayim
גָּבַר	gavar
גֶּבֶר	gever
גְּבַרְבַר	gvarvar
גַּבְרִי	gavri
גַּבְרִי	gavri
גַּבְרִיאֵל	gavriel, gabriel
גְּבָרִים	gvarim
גְּבִרְתִּי	gvirti
גְּבַרְתָּן	gvartan
גְּבַרְתֶּן	gvarten
גַּג	gag
גַּד	gad
גָּד	gad
גַּדָּא	gada
גָּדָה	gada
גָּדוֹל	gadol
גָּדוֹת	gadot
גְּדוֹת־	gdot-
גְּדִי	gdi
גְּדִיָּה	gediya
גָּדַל	gadal
גָּדֹל	gadol
גִּדֵּל	gidel
גֹּדֶל	godel
גֶּדֶם	gedem
גִּדְעוֹן	gidon
גְּדֵרָה	gdera
גֵּו	gev
גּוֹ	go
גּוֹבָה	gova
גּוֹבֶה	gove
גּוֹי	goi
גְּוִיָּה	gviya
גּוֹיִים	goyim
גּוֹלָן	golan
גּוֹלְף	golf
גּוֹנֵב	gonev
גּוֹנְבוֹת	gonvot
גּוֹנְבִים	gonvim
גּוֹנֶבֶת	gonevet
גּוֹסְפֶּל	gospel
גּוּף	guf
גּוּפָה	gufa
גּוּפִים	gufim
גּוּץ	guts
ג׳וּק	juk
גּוּר	gur
גּוֹרָל	goral
גּוּשׁ	gush
גּוּשׁ דָּן	gush dan
גּוּשׁ עֶצְיוֹן	gush etsyon
גּוּשׁ קָטִיף	gush katif
גַּז	gaz
גֶ׳ז	jez
גִּזְבָּר	gizbar
גְּזוּזְטְרָה	gzuztra
גָּזַל	gazal
גֶּזַע	geza
גִּזְעָן	gizean
גָּזַר	gazar
גֶּזֶר	gezer
גִּזְרָה	gizra
גְּזֵרָה	gzera
גזרים	gzarim
גָּחוׂן	gakhon
גָּחוּן	gakhun
גֵּט	get
גִּטִּין	gitin
גַּיְא	gay
גִ׳יבְּרִישׁ	jibrish
גִּיגָבַּיְט	gigabayt
גִּיד הַנָּשֶׁה	gid hanashe
גֵּיהִנּוֹם	geihinom
גִּיּוּס	giyus
גִּיּוּר	giyur
גִיוֹרֶת	giyoret
גִּיחוֹן	gikhon
גִּיטָרָה	gitara
גִּיל	gil
גִּילָה	gila
גִּימֶ״ל	gimel
גִּימֶל	gimel
גִ׳ינְס	jins
גִּיס	gis
גִּיֵּס	giyes
גֻּיַּס	guyas
גִּיסָה	gisa
גִּיר	gir
גִּיֵּר	giyer
גִירִים	girim
גִּירִית	girit
גִ'ירָף	jiraf
גִ׳ירָפָה	jirafa
גִּישָׁה	gisha
גַּל	gal
גִּלְגּוּל	gilgul
גִּלְגּוּל	gilgul
גַּלְגַּל	galgal
גִּלְגָּל	gilgal
גִּלְגֵּל	gilgel
גַּלְגַּל הַצָּלָה	galgal hatsala
גַּלְגַּל שִׁנַּיִם	galgal shinayim
גַּלְגֶּלֶת	galgelet
גֻּלְגֹּלֶת	gulgolet
גָּלָה	gala
גִּלָּה	gila
גֻּלָּה	gula
גִּלּוּחַ	giluakh
גִּלּוּחַ	giluakh
גִּלּוּי	giluy
גְּלוּיָה	gluya
גִּלּוּיִים	giluyim
גְּלוּלָה	glula
גָּלוּת	galut
גַּלָּח	galakh
גִּלֵּחַ	gileakh
גַּל חֹם	gal khom
גְּלִידָה	glida
גְּלִידוֹת	glidot
גְּלִידַת	glidat
גָּלִיל	galil
גְּלִילָהּ	glilah
גָּלְיָת	golyat
גָּלַל	galal
גֹּלֶם	golem
גַּלְעֵד	galed
גִּלְעָד	gilad
גַּל־קוֹל	gal-kol
גָּלַקְסִיָה	galaksia
גַּלְשַׁן שֶׁלֶג	galshan sheleg
גַּם	gam
גם כן	gam ken
גָּמָא	gama
גִּמְגּוּם	gimgum
גַמָּד	gamad
גִּמֵּד	gimed
גַּמָּדִי	gamadi
גַּמָּדִית	gamadit
גַּמֶּדֶת	gameded
גְּמִילוּת חֲסָדִים	gemilut hasadim
גַּמָּל	gamal
גָּמָל	gamal
גַּמֶּלֶת	gamelet
גָּמַר	gamar
גַּן	gan
גֶּן	gen
גַּן־יְלָדִים	gan yladim
גַּן עֵדֶן	gan eden
גַּנָּב	ganav
גָּנַב	ganav
גָּנְבָה	ganva
גָּנְבוּ	ganvu
גָּנַבְנוּ	ganavnu
גָּנַבְתְּ	ganavet
גָּנַבְתָּ	ganavta
גָּנַבְתִּי	ganavti
גְּנַבְתֶּם	ganavtem
גְּנַבְתֶּן	ganavten
גִּנָּה	gina
גְּנוֹסְטִי	gnosti
גְּנוֹסְטִיקָה	gnostiqa
גְּנוֹסִיס	gnosis
גְּנָזִים	gnazim
גְּנִיזָה	gniza
גַּנִּים	ganim
גֶּנִים	genim
גַּנָּן	ganan
גָּנַן	ganan
גַּנֶּנֶת	ganenet
גֶּנֶרָל	general
גַּסְטְרוֹנוֹמִי	gastronomi
גַּעְגּוּעַ	gagua
גֶּפֶן	gefen
גַּפְרוּר	gafrur
גָּ׳קוּזִי	djakuzi
גֶ׳קְסוֹן	jekson
גָּר	gar
גֵּר	ger
גְּרָ״א	gra
גֶּרֶב	gerev
גַּרְבִּיוֹן	garbiyon
גַּרְבִּיוֹנִים	garbiyonim
גַּרְבַּיִם	garbayim
גָּרָה	gara
גָּרָה	gara
גֵּרָה	gera
גֵּרָה	gera
גְּרוּזְיָה	gruzya
גְּרוּזִינִית	gruzinit
גְּרוּטָאָה	grutaa
גָּרוֹן	garon
גְּרוֹנִי	groni
גֵּרוּשִׁין	geirushin
גַּרְזֶן	garzen
גֵּרִים	gerim
גְּרִיסָה	grisa
גָּרַם	garam
גֶּרְמָנִי	germani
גֶּרְמַנְיָה	germanya
גֶּרְמָנִית	germanit
גַּרְעִין	garin
גַּרְעִינֵי	garine
גַּרְעִינִי	garini
גַּרְעִינִים	garinim
גְּרָף	graf
גֵּרֵשׁ	geiresh
גֵּרֵשׁ	geresh
גֹּרַשׁ	gorash
גֵּרְשַׁיִם	gershayim
גֵּרְשֹׁם	gershom
גָּרַת	garat
גַּרְתְּ	gart
גַּרְתָּ	garta
גֵּרַת	gerat
גָּשׁוּם	gashum
גָּשׁוֹשׁ	gashosh
גֶּשֶׁם	geshem
גֻּשְׁפַּנְקָה	gushpanka
גֶּשֶׁר	gesher
גַּת	gat
גִּתִּית	gitit
ד״א	d.a.
דָּאַב	daav
דָּאַג	daag
דְּאָגָה	daga
דַּאֲגָן	daagan
דָּאָה	daa
דֹּאַר	doar
דֹּאַר אֶלֶקְטְרוֹנִי	doar elektroni
דֹּב	dov
דֻּבְדְּבָן	duvdvan
דִּבּוּר	dibur
דְּבוֹרָה	dvora
דָּבָר	davar
דֶּבֶר	dever
דִּבֵּר	diber
דֻּבַּר	dubar
דָּבָר אַחֵר	davar acher
דִּבְּרָה	dibra
דִּבְרֵי הַיָּמִים	divrei hayamim
דִּבְרֵי יְמֵי	divre yme
דְּבָרִים	dvarim
דְּבָרִים אֲחֵרִים	dvarim acherim
דַּבֶּרְךָ	dabercha
דְּבָרְךָ	dvarcha
דְּבַשׁ	dvash
דָּג	dag
דָּג	dag
דִּגְדֵּג	digdeg
דָּגִים	dagim
דֶּגֶל	degel
דִּגֵּל	digel
דֻּגְמָא	dugma
דֻּגְמָה	dugma
דָּגֵשׁ	dages
דַּד	dad
דָּהַר	dahar
דּוֹ	do
דּוּ	du-
דואר זבל	doar-zevel
דּוֹבֵר	dover
דּוֹגְמָה	dogma
דָּוִד	david
דּוֹד	dod
דּוּד	dud
דּוֹדָה	doda
דּוֹדִים	dodim
דּוּדִים	dudim
דִּוּוּר	divur
דּוֹלְפִין	dolfin
דּוֹלָר	dolar
דוּן	dun
דוֹסִי	dosi
דַּוְקָא	davka
דוֹקטוֹר	doktor
דַּוָּר	davar
דּוֹר	dor
דּוֹרוֹן	doron
דּוֹרוֹת	dorot
דּוֹרִית	dorit
דָּחָה	dakha
דַּחְלִיל	dakhlil
דֹּחַן	dochan
דַּחַף	dakhaf
דָּחַף	dakhaf
דַּי	dai
דֵּי	dei
דִּיאֵטָה	dieta
דַּיָּג	dayag
דַּיָּה	daya
דִּיוֹ	diyo
דְּיוֹ	dyo
דִּיּוּן	diyun
דִּיּוּנִים	diyunim
דְּיוֹתָא	dyota
דְּיוֹתָה	dyota
דַּיָּן	dayan
דִּין	din
דִּיסְק קָשִׁיח	disk kashiakh
דִיפְּלוֹמָטִי	diplomati
דִּיפְּלוֹמַטְיָה	diplomatya
דִּיקְטָטוּרָה	diqtatura
דִּיקָן	dikan
דִּירָה	dira
דִּכֵּא	dike
דֻּכָּא	duka
דָּלָה	dala
דְּלִי	dli
דָּלִיק	dalik
דְלעת	dlaat
דֶּלֶק	delek
דְּלֵקָה	dleika
דַּלֶּקֶת	daleket
דָּלֶ״ת	dalet
דָּלֶת	dalet
דֶּלֶת	delet
דֶּלְתָּא	delta
דֶּלְתּוֹת	deltot
דְּלָתוֹת	dlatot
דָּם	dam
דָּמָה	dama
דֶּמֶה	deme
דֵּמוֹקְרַטְיָה	demokratya
דְּמוּת	dmut
דָּמִים	damim
דִּמְיֵן	dimyen
דִּמֵּם	dimem
דְּמָמָה	dmama
דִּמְעָה	dima
דַּמֶּשֶׂק	dammeseq
דָּן	dan
דָּנִיֵּאל	daniyel
דֶּנְיִת	denit
דֶּנְמַרְק	denmark
דֵּעָה	dea
דַּעַת	daat
דַּף	daf
דַּפְדְּפָן	dafdfan
דַּפִּים	dapim
דָּפַק	dafak
דִּפְתָּר	diftar
דֵּצֶמְבֶּר	detsember
דַּק	dak
דִּקְדּוּק	dikduk
דַּקָּה	daka
דַּקָּה	daka
דְּקִירָה	dkira
דָּקֶל	daqel
דֶּקֶל	deqel
דְקָלִים	dkalim
דַּקָּר	dakar
דָּקַר	dakar
דֶּקֶר	deker
דַּר	dar
דָּר	dar
דֹּר	dor
ד״ר	dr
דַּרְבּוּקָה	darbuka
דֶּרֶג	dereg
דְּרַגְנוֹעַ	dragnoa
דָּרוֹם	darom
דְּרוֹר	dror
דָּרְיָוֶשׁ	daryavesh
דָּרַךְ	darach
דֶּרֶךְ	derekh
דֶּרֶךְ אֶרֶץ	derech erets
דַּרְכּוֹן	darkon
דַּרְכּוֹנִים	darkonim
דְּרָכִים	drachim
דַּרְקוֹן	darkon
דְּרָקוֹן	drakon
דָּרַשׁ	darash
ד־ר־שׁ	d-r-sh
דָּשָׁא	dasha
דֶּשֶׁא	deshe
דָּת	dat
דָּתִי	dati
־ָה	-a
־ָהּ	-ah
הֲ־	ha-
הַ־	ha-
הָא	ha
הֵ״א	he
הֵא	he
האו״ם	hau.m.
הָאוֹקְיָנוֹס הָאַטְלַנְטִי	haokyanos haatlanti
הָאוֹקְיָנוֹס הַדְרוֹמִי	haokyanos hadromi
הָאוֹקְיָנוֹס הַהׂדּי	haokyanos hahodi
הָאוֹקְיָנוֹס הַשָּׁקַט	haokyanos hashaket
הָאוֹר	haor
הֶאֱזִין	heezin
הָאֶזְרָח	haezrakh
הָאַחֵרוֹת	haakherot
הָאַחֵרִים	haakherim
הֵאֵט	heet
הָאִינְטֶרְנֶט	hainternet
הֵאִיץ	heits
הֵאִיר	heir
הַאִם	haim
הַאם	ham
הֶאֱמִין	heemin
הָאָרֶץ	haarets
הֶאֱשִׁים	heeshim
הַב	hav
הַבָּא	haba
הָבֵא	have
הִבְדִּיל	hivdil
הֶבְדֵּל	hevdel
הֻבְדַּל	huvdal
הַבְדָּלָה	havdala
הָבָה	hava
הִבְהִיר	hivhir
הַבְהָרָה	havhara
הַבְטָחָה	havtakha
הִבְטִיחַ	hivtiakh
הֵבִיא	hevi
הִבִּיט	hibit
הֵבִיךְ	heivikh
הֵבִין	hevin
הֵבִיס	hevis
הַבַּיִת	habayit
הַבַּיְתָה	habayta
הֶבֶל	hevel
הִבְלִיעַ	hivlia
הֲבָנָה	havana
הֵבַנּוּ	hevanu, hevannu
הֲבָנוֹת	havanot
הֲבָנַת־	havanat-
הברות	havarot
הֻבְרַח	huvrakh
הִבְרִיג	hivrig
הִבְרִיחַ	hiviakh
הַבְּרִית	habrit
הִבְשִׁיל	hivshil
הַגָּאוֹן מִוִּילְנָה	hagaon mivilna
הֲגָבָה	hagava
הַגְבָּהָה	hagbaha
הִגְבִּיל	higbil
הִגְבִּיר	higbir
הֶגְבֵּל	hegbel
הַגְבָּלָה	hagbala
הֻגְבַּר	hugbar
הִגְדִּיל	higdil
הִגְדִּיר	higdir
הַגְדָּרָה	hagdara
הִגְזִים	higzim
הֵגִיב	hegiv
הִגִּיד	higid
הֲגִיָּה	hagiya
הִגִּיעַ	higia
הִגִּישׁ	higish
הַגָּלִיל	hagalil
הֵגֵן	hegen
הֻגְנַב	hugnav
הֲגַנָּה	hagana
הִגְנִיב	higniv
הַגָּעָה	hagaa
הָגָר	hagar
הַגֵּר	hager
הַגָּשָׁה	hagasha
הִדְאִיג	hidig
הִדְגִּישׁ	hidgish
הַדְגָּמָה	hadgama
הֲדָדִי	hadadi
הֹדּוּ	hodu
הִדְלִיק	hidlik
הֲדַס	hadas
הֲדַסָּה	hadasa
הָדָר	hadar
הִדְרִיךְ	hidrikh
הַדְרָכָה	hadrakha
הָהִיסְטוֹרְיוֹגְרַפְיָה	hahistoryografya
‎הָהָר‎	hahar
הַהַשְׂכָּלָה	hahaskala
הֱוֵא	heve
הוּא	hu
הוּאַץ	huats
הוּאַר	huar
הוֹבִיל	hovil
הוּבַל	huval
הוֹד	hod
הוֹדָה	hoda
הוֹדוּ	hodu
הוֹדִיעַ	hodia
הוֹדָעָה	hodaa
הוֹוֶה	hove
הוֹזִיל	hozil
הוּכַח	hukhakh
הוֹכָחָה	hokhakha
הוֹכִיחַ	hokhiakh
הוּכַן	hukhan
הוֹלִיד	holid
הוֹלֵךְ	holekh
הוֹלֵךְ־רֶגֶל	holekh-regel
הוֹלֶכֶת־רֶגֶל	holekhet-regel
הוֹלֵל	holel
הוֹלֵם	holem
הוֹלַנְד	holand
הוֹלַנְדִּי	holandi
הוֹלַנְדִּית	holandit
הוֹמוֹגְרָף	homograf
הוֹמוֹסֶקְסוּאָלִיּוּת	homoseksualiut
הִוֵּן	hiven
הוֹן	hon
הֻוַּן	huvan
הוּנְגָּרִית	hungarit
הוֹסִיף	hosif
הוּסַף	husaf
הוֹעִיל	hoil
הוֹפִיעַ	hofia
הוֹפָעָה	hofaa
הוֹצֵא	hotse
הוֹצִיא	hotsi
הוֹצִיאֲךָ	hotsiacha
הוֹרָאָה	horaah
הוּרַד	hurad
הוֹרְדוֹס	hordus
הוֹרָה	hora
הוֹרָה	hora
הוֹרֶה	hore
הוֹרִיד	horid
הוֹרִים	horim
הוֹרִישׁ	horish
הוֹרֵס	hores
הוּשַׁב	hushav
הוֹשִׁיב	hoshiv
הוֹשִׁיעַ	hoshia
הוֹשֵׁעַ	hoshea
הוֹתִיר	hotir
הִזְדַּיֵּן	hizdayen
הִזְדַּמְּנוּת	hizdamnut
הִזְדַּעֲזֵעַ	hizdaazea
הִזְדַּעַזְעוּת	hizdaazut
הִזְדַּקֵּן	hizdaken
הִזְדַּקְּנוּת	hizdaknut
הִזְדָּרֵז	hizdarez
הַזֶּה	haze
הִזְהִיר	hizhir
הֲזָזָה	hazaza
הֵזִיז	heziz
הִזִּיעַ	hizia
הִזִּיק	hizik
הִזְכִּיר	hizkir
הֻזְכַּר	huzkar
הִזְמִין	hizmin
הַזְמָנָה	hazmana
הִזְרִיק	hizrik
הֶחְבִּיא	hekhbi
הֶחָג	hechag
הֶחָג	hehag
הֶחְדִּיר	hekhdir
החופש הגדול	hakhofesh hagadol
הֶחְזִיק	hekhzik
הֶחְזִיר	hekhzir
הֶחְזֵר	hekhzer
הֶֽחֱזַֽרְתָּ	hekhezarta
הֵחִיל	hekhil
הֵחֵל	hekhel
הֻחְלַט	hukhlat
הַחְלָטָה	hakhlata
הֶחְלִיט	hekhlit
הֵחָלְשׁוּת	heikhalshut
הֶחְמִיץ	hekhmits
הֶחְשִׁיךְ	hekhshikh
הֻחְשַׁךְ	hukhshakh
הִטַּגֵּן	hitagen
הִטָּה	hita
הִטַּהֵר	hitaher
הִטָּהֵר	hitaher
הַטּוֹבִים	hatovim
הַטְמָעָה	hatmaa
הִטַּנֵּף	hitanef
הַטְעָמָה	hatama
הֶטְרוֹסֶקְסוּאָלִיּוּת	heteroseksualiut
הִיא	hi
הָיָה	haya
הַיּוֹם	hayom
הַי טֶק	hai tek
הָיִית	hayit
הָיִיתָ	hayita
הָיִיתִי	hayiti
הֵיכָן	hechan
הֵימִין	heimin
הִיסְטוֹרִי	histori
הִיסְטוֹרְיוֹגְרַפְיָה	historyografya
הִיפּוֹפּוֹטָם	hiypopotam
הַיַּרְדֵּ֔ן	hayyarden
הַיִּשּׁוּב	hayishuv
הַיִּשְׂרְאֵלִי	hayisreli
הַיִּשְׂרְאֵלִית	hayisrelit
הָיְתָה	haita
הִכְאִיב	hikhiv
הִכָּה	hika
הֻכָּה	huka
הִכְחִישׁ	hikhkhish
הֲכִי	hakhi
הֵכִיל	hekhil
הֵכִין	hekhin
הִכִּיר	hikir
הִכִּישׁ	hikish
הֲכָנָה	hakhana
הִכְנִיס	hikhnis
הַכְנָסָה	hakhnasa
הַכְּנֶסֶת	hakneset
הִכְעִיס	hikhis
הֻכַּר	hukar
הַכָּרָה	hakara
הִכְרִיז	hikhriz
הִכְרִיחַ	hikhriakh
הִכְשִׁיר	hikhshir
הֶכְשֵׁר	hekhsher
הֻכְשַׁר	hukhshar
הִכְתִּיב	hikhtiv
הִכְתִּים	hikhtim
הִכְתִּיר	hikhtir
הֻכְתַּר	hukhtar
הִלְבִּין	hilbin
הִלְבִּישׁ	hilbish
הֻלֶּדֶת	huledet
הִלְהִיט	hilhit
הַלְוַאי	halvay
הִלְחִים	hilkhim
הֶלְיוּם	helyum
הֲלִיכָה	halikha
הַלִּיכּוּד	ha-likud
הֲלִיכוֹת	halichot
הֲלִיכַת	halichat
הַלַּיְלָה	halayla
הָלַךְ	halakh
הָלַךְ לְאִבּוּד	halakh libud
הָלַךְ לְעוֹלָמוֹ	halach lolamo
הֲלָכָה	halakha
הָלְכָה	halkha
הֲלָכוֹת	halakhot
הִלְכוֹת	hilkhot
הִלְכָתִי	hilkhati
הִלֵּל	hilel
הַלְלוּ	hallu
הַלְּלוּיָהּ	halluyah
הֵם	hem
הם	him
הַמֵּאָה	hamea
הָמָה	hama
הֵמָּה	hema
הָמוֹן	hamon
הַמּוֹצִיא	hamotzi
המחשבה	hamakhshava
הָמַחְשָׁבוֹת	hamakhshavot
הִמְלִיחַ	himliakh
הִמְלִיךְ	himlikh
הִמְלִיץ	himlits
הַמְלָצָה	hamlatsa
הַמֶּמְשָׁלָה	hamemshala
הָמָן	haman
המערב	hamaarav
הַמְצָאָה	hamtsaa
הִמְצִיא	himtsi
הַמָּקוֹם	hamakom
הֲמָרָה	hamara
הִמְרִיא	himri
הַמִשְׂחָקִים הַאוֹלִימְפִּיִּים	hamiskhakim haolimpiyim
הִמְשִׁיךְ	himshikh
הֶמְשֵׁךְ	hemshekh
הֶמְשֵׁךְ יָבוֹא	hemshekh yavo
הֶמְשֵׁכִי	hemshekhi
הַמִּשְׁכָּן	hamishkan
הִמְתִּין	himtin
הִמְתִּינוּ	himtinu
הֵן	hen
הַנְדָּסָה	handasa
הֵנָּה	hena
הִנָּה	hina
הִנֵּה	hine
הִנְהִיג	hinhig
הֲנָחָה	hanakha
הִנְחָה	hinkha
הֵנִיחַ	heniakh
הַנַּכְּבָּה	hanakba
הֵסֵב	hesev
הִסְבִּיר	hisbir
הֶסְבֵּר	hesber
הִסְגִּיר	hisgir
הַסְּטוּדֶנְטִים	hastudentim
הִסְטוֹרְיָה	historia
הִסִּיעַ	hisia
הֵסִיר	hesir
הִסְכִּים	hiskim
הֶסְכֵּם	heskem
הַסְכָּמָה	haskama
הַסְלָמָה	haslamah
הִסְמִיק	hismik
הֻסַּע	husa
הַסָּעָה	hasaa
הִסְפִּיק	hispik
הֲסָרָה	hasara
הִסְתַּגֵּר	histager
הִסְתַּדְּרוּת	histadrut
הֲסָתָה	hasata
הִסְתַּיֵּם	histayem
הִסְתִּיר	histir
הִסְתַּכֵּל	histakel
הִסְתָּעֵף	histaef
הִסְתַּתֵּר	histater
הָעֲבוֹדָה	haavoda
הֶעֱבִיד	heevid
הֶעֱבִיר	heevir
הֶעֱדִיף	heedif
הֵעָדֵר	header
הָעוֹלָם	haolam
הֵעֵז	heez
הֵעִיף	heif
הָעִיר	hair
הֵעִיר	heir
הֶעֱלָה	heela
הָעָם	haam
הָעֲמִידָה	amida
הָעֶרֶב	haerev
הָעֲרָבָה	haarava
הֶעֱרִיץ	heerits
הִפְגִּין	hifgin
הָפוּךְ	hafukh
הִפְחִיד	hifkhid
הִפְחִית	hifkhit
הַפְחָתָה	hafkhata
הִפְטִיר	hiftir
הַפְטָרָה	haftara
הָפִיךְ	hafikh
הַפִּירָמִידָה	hapiramida
הָפַך	hafakh
הֲפֵכָה	hafekha
הִפְלִיא	hifli
הִפְלִיץ	hiflits
הִפְנָה	hifna
הִפְסִיד	hifsid
הִפְסִיק	hifsik
הַפְסָקָה	hafsaka
הַפְסָקַת־אֵשׁ	hafsakat-esh
הִפְעִיל	hifil
הִפְצִיר	hiftsir
הִפְקִיעַ	hifki
‎הַפָּר	hapar
הַפְרָדָה	hafrada
הִפְרִיד	hifrid
הִפְרִיעַ	hifria
הַפְרָעָה	hafraa
הֻפְשַׁט	hufshat
הִפְשִׁיט	hifshit
הִפְתִּיעַ	hiftia
הַפְתָּעָה	haftaa
הִצְבִּיעַ	hitzbia
הַצָּגָה	hatzaga
הִצְהִיר	hitshir
הִצְחִיק	hitskhik
הִצְטַבְרֵחַ	hitstavreakh
הִצְטַחֵק	hitstakhek
הִצְטַלֵּם	hitztalem
הִצְטַנֵּן	hitstanen
הִצִּיג	hitsig
הִצִּיל	hitsil
הַצִּילוּ	hatzilu
הַצִּילֵנוּ	hatsilenu
הִצִּילָנוּ	hitsilanu
הִצִּיעַ	hitsia
הֵצִיץ	heitsits
הִצִּית	hitsit
הֻצַּל	hutsal
הַצָּלָה	hatsala
הַצְלָחָה	hatzlakha
הִצְלִיחַ	hitzliakh
הַצָּעָה	hatsaa
הַצְרָנָה	hatsrana
הִקְבִּיל	hikbil
הַקָּדוֹשׁ בָּרוּךְ הוּא	haqqados baruk hu
הִקְדִּישׁ	hikdish
הִקְהִיל	hikhil
הַקְהֵל	hak-hel
הַקֹּטֶב	hakotev
הִקְטִין	hiktin
הֵקִים	heikim
הֵקִימוּ	heikimu
הִקִּיף	hikif
הֲקַלָּה	hakala
הֲקָלָה	hakala
הַקַּלָּה	hakala
הִקְלִיד	hiklid
הִקְלִיק	hiklik
הֲקָמָה	hakama
הִקְסִים	hiksim
הֻקַּף	hukaf
הַקְפָּאָה	hakpaa
הִקְפִּיא	hikpi
הֵקֵר	heker
הִקְרִיא	hikri
הִקְרִיס	hikris
הִקְשִׁיב	hikshiv
הַקַּשׁ שֶׁשָּׁבַר אֶת גַּב הַגָּמָל	hakash sheshavar et gav hagamal
‎הַר‎	har
הֶרְאָה	hera
הָרִאשׁוֹן	harishon
הַרְבֵּה	harbe
הִרְבָּה	hirba
הָרַג	harag
הֶרֶג	hereg
הִרְגִּיעַ	hirgia
הִרְגִּישׁ	hirgish
הַרְגָּשָׁה	hargasha
הָרָה	hara
הָרֶה	hare
הַר הָאֱלֹהִים	har haelohim
הָרוּג	harug
הִרְוִיחַ	hirviakh
הֵרוֹן	heron
הִרְחִיב	hirkhiv
הִרְחִיק	hirkhik
הִרְטִיב	hirtiv
הָרֵי	hare
הֲרֵי	harei
הֵרָיוֹן	herayon
הֵרִיחַ	heriakh
הָרִים	harim
הֵרִים	herim
הֲרִיסָה	harisa
הִרְכִּיב	hirkiv
הַר מְגִדּוֹ	har megiddo
הָרַס	haras
הֶרֶס	heres
הֵרֵס	heres
הֹרַס	horas
הר סיני	har sinay
הִרְעִיל	hiril
הֻרְעַל	hural
הַרְצָאָה	hartsaa
הִרְצָה	hirtsa
הֶרְצֵלִיָּה	hertseliyya
הֲרָרִים	hararim
הִרְשָׁה	hirsha
הִרְשִׁים	hirshim
הַר שֻׁלְחָן	har shulkhan
הָשֵׁב	hashev
הַשׁוֹאָה	ha-shoa
הַשְׁוָאָה	hashvaa
הִשְׁוָה	hishva
הַשּׁוֹמְרוֹן	hashomron
הֵשִׁיב	heshiv
הִשִּׂיג	hisig
הַשְׂכָּלָה	haskala
הֻשְׁלַט	hushlat
הִשְׁלִיט	hishlit
הִשְׁלִיךְ	hishlikh
הַשְׁלִיכֵהוּ	hashlichehu
הִשְׁלִים	hishlim
הַשֵּׁם	hashem
הִשְׁמִיד	hishmid
הִשְׁמִין	hishmin
הִשְׁמִיעַ	hishmia
הִשְׁפִּיל	hishpil
הִשְׁפִּיעַ	hishpia
הַשְׁפָּעָה	hashpaa
הִשְׁקָה	hishka
הִשְׁקִיעַ	hishkia
הַשְׁקָעָה	hashkaa
הִשְׁתַּגֵּעַ	hishtagea
הִשְׁתַּדֵּל	hishtadel
הִשְׁתּוֹחֵחַ	hishtokheakh
הִשְׁתַּזֵּף	hishtazef
הִשְׁתַּחֲוָה	hishtakhava
הִשְׁתַחְרֵר	hishtakhrer
הִשְׁתִּיל	histil
הִשְׁתִּין	hishtin
הִשְׁתִּיק	hishtik
הִשְׁתַּכְנֵעַ	hishtachnea
הִשְׁתַּכֵּר	hishtaker
הִשְׂתַּכֵּר	histaker
הִשְׁתַּלֵּחַ	hishtaleakh
הִשְׁתַּלֵּט	hishtalet
הִשְׁתַּמֵּר	hishtamer
הִשְׁתַּמֵּשׁ	hishtamesh
הִשְׁתַּפֵּר	hishtaper
הִשְׁתַּתֵּף	hishtatef
הִתְאַבֵּד	hitabed
הִתְאַבֵּךְ	hitabekh
הִתְאַבֵּל	hitabel
הִתְאַדָּה	hitada
הִתְאַהֵב	hitahev
הִתְאוֹשֵׁשׁ	hitoshesh
הִתְאַזֵּן	hitazen
הִתְאַזְרֵחַ	hitazreakh
הִתְאַכְזֵב	hitakhzev
הִתְאַמֵּץ	hitamatz
הִתְאַסֵּף	hitasef
הִתְבַּדֵּחַ	hitbadeakh
הִתְבּוֹדֵד	hitboded
הִתְבַּזְבֵּז	hitbazbez
הִתְבַּטֵּא	hitbate
הִתְבַּטְּאוּת	hitbatut
הִתְבַּלְבֵּל	hitbalbel
הִתְבַּלָּה	hitbala
הִתְבַּשֵּׁל	hitbashel
הִתְגַּבֵּר	hitgaber
הִתְגַּיֵּס	hitgayes
הִתְגַּיֵּר	hitgayer
הִתְגַּלְגֵּל	hitgalgel
הִתְגַּלָּה	hitgala
הִתְגַלֵּחַ	hitgaleach
הִתְגַּעֲגֵעַ	hitgaagea
הִתְגָּרֵשׁ	hitgaresh
הִתְוַדֵּעַ	hitvadea
הִתְוַכֵּחַ	hitvakeach
הִתְחַבֵּא	hitkhabe
הִתְחַבֵּר	hitkhaber
הִתְחַיְּבוּת	hitkhayvut
הִתְחִיל	hitkhil
הַתְחָלָה	hatkhala
הַתְחָלוֹת	hatkhalot
הִתְחַמֵּם	hitchamem
הִתְחַנֵּךְ	hitkhanekh
הִתְטַגֵּן	hitagen
הִתְיַבֵּשׁ	hityabesh
הִתִּיז	hitiz
הִתְיַחֵס	hityakhes
הִתְיָעֲצוּת	hityaatsut
הִתְיַקֵּר	hityaker
הִתְיַקְּרוּת	hityakrut
הִתִּיר	hitir
הִתִּישׁ	hitish
הִתְיַשֵּׁב	hityashev
הִתְכַּוֵּן	hitkaven
הִתְכּוֹנֵן	hitkonen
הִתְכּוֹפֵף	hitkofef
הִתְכַּנֵּס	hitkanes
הִתְכַּנְּסוּת	hitkansut
הִתְכַּתֵּב	hitkatev
הִתְלַבֵּשׁ	hitlabesh
הִתְלַהֲבוּת	hitlahavut
הִתְלוֹנֵן	hitlonen
הִתְלַכְלֵךְ	hitlachlech
הִתְמַהְמֵהַּ	hitmahmeah
הִתְמוֹדֵד	hitmoded
הִתְמַכֵּר	hitmaker
הִתְמַכְּרוּת	hitmakrut
הִתְמַלֵּא	hitmale
הִתְמַצֵּא	hitmatse
הִתְנַבֵּא	hitnabe
הִתְנַגֵּד	hitnaged
הִתְנַגְּדוּת	hitnagdut
הִתְנַדֵּב	hitnadev
הִתְנֻדַּב	hitnudav
הִתְנַהֵג	hitnaheg
הִתְנַהֲגוּת	hitnahagut
התנ״ך	hatanakh
הִתְנַכֵּר	hitnaker
הִתְנַסָּה	hitnasa
הִתְנַעֵר	hitnaer
הִתְנַפֵּל	hitnapel
הִתְנַצֵּל	hitnatsel
הִתְנַקֵּשׁ	hitnakesh
הִתְנַקְּשׁוּת	hitnaqshut
הִתְנַשֵּׁק	hitnashek
הִתְעוֹרֵר	hitorer
הִתְעַטֵּף	hitatef
הִתְעַלָּה	hitala
הִתְעַלֵּל	hitalel
הִתְעַלְּלוּת	hitallut
הִתְעַלֵּף	hitalef
הִתְעַצֵּל	hitatsel
הִתְעַקֵּשׁ	hitakesh
הִתְעָרֵב	hitarev
הִתְפּוֹצֵץ	hitpotsets
הִתְפַּטֵּר	hitpater
הִתְפֻּטַּר	hitputar
הִתְפַּלֵּא	hitpale
הַתְפָּלָה	hatpala
הִתְפַּלֵּל	hitpalel
הִתְפַסְפֵס	hitfasfes
הִתְפָּרֵד	hitpared
הִתְפַּרְסֵם	hitparsem
הִתְפַּשֵּׁט	hitpashet
הִתְפַּתָּה	hitpata
הִתְפַּתְּחוּת	hitpatkhut
הִתְקַבֵּל	hitkabel
הִתְקַדֵּם	hitkadem
הִתְקַדֵּשׁ	hitkadesh
הִתְקַהֵל	hitkahel
הִתְקוֹמֵם	hitkomem
הִתְקוֹמְמוּת	hitkomemut
הִתְקִיף	hitkif
הִתְקַלֵּחַ	hitkaleach
הִתְקַלְקֵל	hitkalkel
הִתְקַמֵּט	hitkamet
הִתְקַנֵּא	hitkane
הֻתְקַף	hutkaf
הַתְקָפָה	hatkafa
הִתְקָרֵב	hitkarev
הִתְקָרֵחַ	hitkareakh
הִתְקָרְחוּת	hitkarkhut
הִתְקַשֵּׁר	hitkasher
הַתְרָאָה	hatraa
הִתְרָאָה	hitraa
הִתְרַבָּה	hitraba
הִתְרַגֵּז	hitragez
הִתְרַגֵּל	hitragel
הִתְרַגְּשׁוּת	hitragshut
הִתְרוֹמֵם	hitromem
הִתְרוֹקֵן	hitroken
הִתְרַחֵץ	hitrakhetz
הִתְרַחֵשׁ	hitrakhesh
הִתְרַפֵּא	hitrape
־וֹ	-o
־וּ	-u
וְ־	v-
וְ	vo
וַאלְלָה	walla
וְאָמַר	vamar
וָאֹמַר	vaomar
וְאָמְרוּ	vamru
וְאָמַרְתְּ	vamart
וְאָמַרְתָּ	vamarta
וְאָמַרְתִּי	vamarti
וַאֲמַרְתֶּם	vaamartem
וְאָסַפְתָּ	vasafta
וָאֵרֵד	vaered
וּבָאת	uvat
וּבָאתָ	uvata
וּבְכֵן	uvkhen
וַדָּאִי	vadai
וַדַּאי	vaday
וְדִבֶּר	vdiber
וְדִבַּרְתָּ	vdibarta
וְהוֹרֵיתִי	vhoreti
וְהוֹרֵיתִיךָ	vhoreticha
וְהָיָה	vhaya
וְהָיוּ	vhayu
וְהִכֵּיתִי	vhiketi or vhiketi
וָ״ו	vav
וָו	vav
וואו	wau
ווֹדְקָה	vodka
ווֹלְקָנִי	volkani
ווּסווּסִים	vusvusim
וֵטוֹ	veto
וַיַּאֲמֵן	vayaamen
וַיֹּאמֶר	vayomer
וַיֹּאמְרוּ	vayomru
וַיֵּאָנְחוּ	vayeanchu
וַיָּבֵא	vayave
וַיָּבֹא	vayavo
וַיָּבִאוּ	vayaviu
ויבאו	vayavo
וַיָּבֹאוּ	vayavou
וַיָּבוֹא	vayavo
וַיִּבֶן	vayiven
וַיְבַקֵּשׁ	vayvakesh
וַיְבֻקַּשׁ	vayvukash
וַיִּבְרַח	vayivrach
וַיְגַדֵּל	vaygadel
וַיִּגְדַּל	vayigdal
וַיְגָרְשׁוּם	vaygarshum
וִידֵאוֹ	video
וַיֵּדַע	vayeda
וַיֹּדַע	vayoda
וַיְהִי	vayhi
וַיּוֹצִאָהּ	vayotsiah
וַיּוֹשִׁעָן	vayoshian
וִיזוּאָלִי	vizuali
וַיִּזְכֹּר	vayizkor
וַיִּזְעֲקוּ	vayizaku
וַיַּחֲזֶק	vayachazek
וַיְחַזֵּק	vaychazek
וַיֶּחֱזַק	vayechezak
וַיִּטְמְנֵהוּ	vayitmnehu
וְיֶטְנָאם	vyetnam
וַיִּירָא	vayira
וַיַּךְ	vayach
וִילוֹן	vilon
וַיֵּלֶךְ	vayelech
וִילְנָה	vilna
וַיָּמָת	vayamot
וִינָה	vina
וַיִּנְהַג	vayinhag
וַיָּנָס	vayanos
וִיסְקִי	viski
וַיַּסְתֵּר	vayaster
וַיִּסָּתֵר	vayisater
וַיַּעַן	vayaan
וַיַּעַשׂ	vayaas
וַיִּפְגְּשֵׁהוּ	vayifgshehu
וַיִּפֶן	vayifen
וַיֵּצֵא	vayetse
וְיָצָא	vyatsa
וַיִּקַּח	vayikach
וִיקִי	viki
וִיקִימִילּוֹנִים	vikimilonim
וִיקִימִלּוֹן	vikimilon
וִיקִיפֶּדְיָה	vikipedya
וִיקִיפֶּדְיוֹת	vikipedyot
וַיָּקָם	vayakom
וַיִּקְרָא	vayikra
וַיַּרְא	vayar
וַיֵּרָא	vayera
וַיַּרְכִּבֵם	vayarkivem
וַיָּשֶׁב	vayashev
וַיָּשָׁב	vayashov
וַיֵּשֶׁב	vayeshev
וַיִּשְׁבְּ	vayishb
וַיִּשְׁלַח	vayishlach
וַיַּשְׁלִיכֵהוּ	vayashlichehu
וַיִּשְׁמַע	vayishma
וַיְשַׁמַּע	vayshama
וַיִּשְׁמְעוּ	vayishmu
וַיַּשְׁקְ	vayashk
וַיִּשַּׁק	vayishak
וַיִּשְׁתַּחֲוּוּ	vayishtakhavu
וַיִּתֵּן	vayiten
וְכוּ׳	vkhu.
וִכּוּחַ	vikuakh
וְלָקַחְתָּ	vlakachta
־וֹן	-on
וֶנוּס	venus
וֶנְטִילָטוֹר	ventilator
וֶנֶצְיָה	venetsya
וְנָתַתִּי	vnatati
וַעַד	vaad
וְעָדָה	vada
וָפֶל	vafel
וְרָאֲךָ	vraacha
וָרֹד	varod
וֶרֶד	vered
וְרָדִים	vradim
וְרַדְרַד	vradrad
וְרִיד	vrid
וְשָׁאֲלָה	vshaala
וְשָׁלַחְתִּי	vshalachti
וְשִׁלַּחְתִּי	vshilachti
וְשָׂמַח	vsamach
וְשִׂמַּח	vsimach
וְשָׁמְעוּ	vshamu
וְשַׂמְתָּם	vsamtam
וְשַׂמְתֶּם	vsamtem
וְשָׁפַכְתָּ	vshafachta
־וֹת	-ot
וַתֹּאמֶר	vatomer
וַתֹּאמַרְןָ	vatomarna
וַתְּבִאֵהוּ	vatviehu
וַתָּבֹאנָה	vatavona
וַתַּחְמֹל	vatachmol
וָתִיק	vatik
וַתֵּלֶד	vateled
וַתֵּלֶךְ	vatelech
וַתְּמַלֶּאנָה	vatmalena
וַתַּעַל	vataal
וַתִּפְתַּח	vatiftach
וַתִּקָּחֶהָ	vatikacheha
וַתִּקְרָא	vatikra
וִתֵּר	viter
וַתֵּרֶא	vatere
וַתִּרְאֵהוּ	vatirehu
וַתֵּרֶד	vatered
וַתָּשֶׂם	vatasem
זְאֵב	zev
זֹאת	zot
זַבְדִּי	zabdi
זָבָה	zava
זָבָה	zava
זְבוּב	zvuv
זְבוּבִים	zvuvim
זְבוּלוּן	zvulun
זְבֻל	zvul
זֶבְּרָה	zebra
זָבַת	zavat
זַגָּג	zagag
זִגֵּג	zigeg
זֵד	zed
זֶה	ze
זָהָב	zahav
זֵהָה	zeha
זֵהֶה	zehe
זִהָה	ziha
זֹהָה	zoha
זֶהוּ	zehu
זִהוּי	zihui
זִהוּם	zihum
זָהִיר	zahir
זְהִירוּת	zhirut
זִהֵם	zihem
זֹהַם	zoham
זֹהַר	zohar
זֹהַר הַדָּרוֹם	zohar hadarom
זֹהַר הַצָּפוֹן	zohar hatsafon
זֹהַר קָטְבִּי	zohar kotbi
זוֹ	zo
זוּ	zu
זוֹאוֹלוֹגְיָה	zoologya
זוּג	zug
זוּז	zuz
זוּז	zuz
זוֹחֵל	zoel
זוּטָר	zutar
זָוִית	zavit
זוֹל	zol
זוֹלֵג	zoleg
זוּלַת	zulat
זוּלָת	zulat
זוֹנָה	zona
זוֹנֶה	zone
זוֹרֵם	zorem
זָז	zaz
זַחַל	zakhal
זִיו	ziv
זִיּוּן	ziyun
זִיּוּף	ziyuf
זַיָּן&lt;--	zayan
זַיִ״ן	zayin
זַיִן	zayin
זִיֵּן	ziyen
זינים	zeinim
זִיעַ	zia
זִיף	zif
זִיקּוּק	ziquq
ֵזִיקּוּקֵי דִּי-נוּר	zikukei di-nur
זִיקְפָּה	zikpa
זִירָה	zira
זַיִת	zayit
זֵיתָא	zeta
זֵיתִים	zetim
זַךְ	zakh
זָכָה	zakha
זְכוּכִית	zkhukhit
זָכוֹר	zachor
זָכוּר	zachur
זְכוֹר	zchor
זַכּוֹת	zakot
זַכּוּת	zakut
זְכוּת	zkhut
זָכַר	zachar
זָכָר	zachar
זֵכֶר	zecher
זִכָּרוֹן	zikaron
זִכְרִי	zichri
זִכְרֵי	zikhrei
זִכְרִי	zikhri
זְכַרְיָה	zkharya
זְכָרִים	zcharim
ז״ל	ze lshono
ז״ל	z.l.
זִלְפָּה	zilpa
זַמְזַם	zamzam
זָמִין	zamin
זָמַם	zamam
זְמָם	zmam
זְמָן	zman
זְמַנִּים	zmanim
זַמָּר	zamar
זָמַר	zamar
זֶמֶר	zemer
זִמֵּר	zimer
זֻמַּר	zumar
זַמָּרִים	zamarim
זְמָרִים	zmarim
זַן	zan
זָן	zan
זָנָב	zanav
זְנָבוֹ	znavo
זַנְגְּבִיל	zangvil
זְנוּת	znut
זָנַח	zanakh
זְנִיחָה	znikha
זָע	za
זֵעָה	zea
זֵעָה	zea
זַעֲזוּעַ	zaazua
זִעְזֵעַ	zizea
זֻעְזַע	zuza
זָעִיר	zair
זָעַם	zaam
זַעַם	zaam
זָעַף	zaaf
זָעַק	zaak
זָקוּק	zakuk
זָקַן	zaqan
זָקָן	zaqan
זָקֵן	zaqen
זִקְנָה	zikna
זִקְנֵי	zikne
זָקַף	zakaf
זָר	zar
זֵר	zer
זַ׳רְגוֹן	zhargon
זְרוֹעַ	zroa
זָרַח	zarach
זֶרַח	zerakh
זָרִיז	zariz
זְרִיחָה	zrikha
זְרִיקָה	zrika
זְרִיקוֹת	zrikot
זֶרֶם	zerem
זָרַע	zara
זֶרַע	zera
זְרָעִים	zraim
זָרַק	zarak
חַאג׳	khaj
חַאלַבּ	khalab
חַבַּ״דְנִיק	khabadnik
חַבַּדְנִיק	khabadnik
חִבּוּק	khibuk
חָבַט	khavat
חָבִיב	khaviv
חָבִית	khavit
חֲבִיתָה	khavita
חֲבָל	khaval
חֶבֶל	khevel
חִבֵּל	khibel
חַבָּלָה	khabala
חֲבָלָה	khavala
חֲבַצֶלֶת	havatzelet
חֲבָק	khavak
חָבַק	khavaq
חֶבֶק	khevek
חִבֵּק	khibek
חֲבַקּוּק	khavakuk
חָבַר	khavar
חָבֵר	khaver
חֶבֶר	khever
חִבֵּר	khiber
חֻבַּר	khubar
חֲבֵרָה	khavera
חֶבְרָה	khevra
חֶבְרֶה	khevre
חֶבְרוֹן	khevron
חֲבָרוֹת	havarot
חֲבֵרוֹת	haverot
חֲבֵרוּת	haverut
חִבְרוּת	hivrut
חַבְרוּתָא	habruta
חֲבֵרִים	khaverim
חֲבֵר כְּנֶסֶת	khaver kneset
חַג	chag
חַג׳	khaj
חָגָב	chagav
חָגַג	khagag
חַג הָאוּרִים	khag haurim
חַג הַמּוֹלָד	chag hamolad
חֲגוֹרָה	khagora
חַגֵּי־	khagei
חַגַּי	khaggay
חֲגִיגָה	khagiga
חֲגִיגִי	khagigi
חַגִּים	chagim
חַג שָׂמֵחַ	khag sameakh
חַד	had
חָד	had
חַד	had-
חַד אֵיבָר	khad eivar
חַד גּוֹנִי	khad goni
חִדּוּשׁ	khidush
חֲדִירָה	khadira
חַד עַיִן	had-ayin
חִדֶּקֶל	khidekel
חָדַר	khadar
חֶדֶר	kheder
חֲדֵרָה	khadera
חָדְרָה	khadra
חַדְרֵי	khadre
חֲדָרִים	khadarim
חֲדַר־מִיּוּן	khadar-miyun
חָדָשׁ	khadash
חַדֵּשׁ	khadesh
חִדֵּשׁ	khidesh
חֹדֶשׁ	khodesh
חֲדָשׁוֹת	khadashot
חָדְשִׁי	chodshi
חֲדָשִׁים	khadashim
חֳדָשִׁים	khodashim
חוֹב	khov
חוֹבָה	khova
חַוָּה	khava
חָוָה	khava
חִוּוּט	khivut
חוֹזֶה	choze
חִוֵּט	khivet
חוּט	khut
חוֹל	hol
חול	hol
חוּ״ל	hu.l.
חוֹלוֹן	kholon
חוֹלֵל	kholel
חוֹלָם	kholam
חוּם	khum
חוֹמָה	khoma
חוֹנֵךְ	khonekh
חוֹף	khof
חוּץ	khutz
חוּץ מִ־	khuts mi-
חוּץ מִזֶה	khuts mize
חוֹקֵר	khoker
חוֹקֶּרֶת	khokeret
חוּר	ur
חִוֵּר	khiver
חוֹשֵׁב	khoshev
חוֹתֵן	khoten
חֲזִיר	khazir
חָזָ״ל	khazal
חַזָּן	khazan
חָזַק	chazak
חָזָק	chazak
חִזֵּק	chizek
חִזֵּק	khizek
חֹזֶק	khozek
חֻזַּק	khuzak
חֲזָקָה	chazaka
חָזְקָה	chazka
חָזַר	chazar
ח־ז־ר	h-z-r
חֲזָרָה	khazara
חַטָּא	khata
חָטָא	khata
חֵטְא	khet
חִטָּה	khita
חָטוּף	khatuf
חָטוּף	khatuf
חֲטַף סֶגּוֹל	khataf segol
חֲטַף פַּתָּח	khataf patakh
חֲטַף קָמָץ	khataf kamats
חֹטֶר	khoter, hoter
חַי	khay
חַיְדַּק	haydaq
חַיָּה	khaya
חַיָּה	khaya
חִיּוּבִי	khiyuvi
חִיּוּךְ	khiyukh
חַיֵּיהֶם	chayehem
חַיִּים	hayim
חַיִּים	khayim
חַיִּים	khayim
חיים פרטיים	khayim pratiyim
חִיֵּךְ	khiyekh
חַיָּל	khayal
חַיִל	khayil
חִיֵּל	khiyel
חֵיל אֲוִיר	kheil avir
חַיָּלִים	chayalim
חימם	khimem
חֵיפָה	kheifa
חֵיקוֹ	cheko
חִירִיק	khirik
חֵי״ת	khet
חֵית	khet
חַיַּת מַחְמָד	khayat makhmad
חִכָּה	khika
חָכַם	khakham
חָכָם	khakham
חָכְמָה	khokhma
חָכְמִוֹת	khakhamut
חָכְמִים	khakhamim
חֹל	hol
חָל	khal
חָלַב	khalav
חָלָב	khalav
חֵלֶב	khelev
חַלְבָה	khalva
חִלְבָּה	khilba
חֶלְבּוֹן	chelbon
חֲלָבִים	khalavim
חלב ישראל	chalav yisrael
חֶלֶד	kheled
חֹלֶד	kholed
חֻלְדָּה	hulda
חַלָּה	khala
חַלְוָה	khalva
חֲלוֹם	khalom
חֲלוֹמוֹת	khalomot
חַלּוֹן	khalon
חִלּוּן	khilun
חַלּוֹנוֹת	khalonot
חִלּוֹנִי	khiloni
חַלְחֹלֶת	khalkholet
חַלְטוּרָה	khaltura
חֻלְיָה	hulya
חָלִיל	khalil
חָלִילָה	khalila
חֲלִיפָה	khalifa
חִלֵּל	hillel
חָלַם	khalam
חָלָס	halas
חָלַף	khalaf
חֻלְצָה	khultsa
חָלַק	khalak
חָלָק	khalak
חֵלֶק	khelek
חֵלֶק דִּבּוּר	khelek dibur
חֲלֵקֵי־	khalkei-
חֶלְקִי	khelki
חַלָּשׁ	khalash
חַם	kham
חָם	kham
חֹם	khom
חֶמְאָה	khema
חָמַד	khamad
חֶמֶד	khemed
חַמָּה	khama
חֵמָה	khema
חָמוּד	khamud
חָמוּץ	khamutz
חֲמוֹר	khamor
חָמוּר	khamur
חָמוֹת	khamot
חַמִּין	khamin
חֲמִיצָה	chamitzah
חֲמִישִׁי	khamishi
חָמַל	khamal
חֶמְלָה	khemla
חַמָּנִית	chammanit
חָמָס	khamas
חַמְסִין	khamsin
חָמֵץ	khamets
חֹמֶץ	khomets
חִמְצָה	khimtsa
חֻמְצָה	khumtsa
חֻמְצָה	khumtza
חַמְצָן	khamtsan
חַמָּר	chamar
חֲמֹר	chamor
חֶמֶר	chemer
חִמֵּר	chimer
חֹמֶר	chomer
חֹמֶר	khomer
חֲמַרְמֹרֶת	khamarmoret
חָמֵשׁ	khamesh
חֲמִשָּׁה	khamisha
חֲמִשָּׁה עָשָׂר	khamisha asar
חֲמִשִּׁים	khamishim
חֲמֵשׁ עֶשְׂרֵה	khamesh esre
חֵן	chen
חָנָה	hana
חַנָּה	khana
חֲנוֹךְ	khanokh
חִנּוּךְ	khinukh
חִנּוּךְ גּוּפָנִי	khinukh gufani
חִנּוּךְ מְיֻחָד	khinukh myukhad
חִנּוּכֵי־	khinukhei-
חְנוּן	khnun
חְנוּנִית	khnunit
חֲנוּת	khanut
חַנְיוֹן	khanyon
חֲנֻיּוֹת	khanuyot
חָנַךְ	khanakh
חִנֵּךְ	khinekh
חֻנַּךְ	khunakh
חֲנֻכָּה	hanukka
חֲנֻכָּה	khanuka
חֲנֻכִּיָּה	khanukiya
חִנָּם	hinam
חָנַן	hanan
חָנָן	hanan
חָנַק	khanak
חַנְקָן	khankan
חָס	khas
חֶסֶד	khesed
חָסָה	khasa
חָסָה	khasa
חָסִיד	khasid
חֲסִידִי	khasidi
חָסַךְ	khasakh
חָסֵר	khaser
חֹסֶר־אוֹנִים	khoser-onim
חִסָּרוֹן	khisaron
חִפָּה	khipa
חֻפָּה	khupa
חִפּוּשׂ	khipus
חִפּוּשִׁית	khipushit
חֲפִיר	khafir
חָפַף	khafaf
חָפַץ	hafats
חֵפֶץ	hefets
חָפַר	khafar
חֲפַרְפֶּרֶת	hafarperet
חִפֵּשׂ	khipes
חֹפֶשׁ	khofesh
חֻפַּשׁ	khupas
חֻפַּשׁ	khupash
חֻפְשָׁה	khufsha
חָפְשִׁי	khofshi
חָפְשִׁיָּה	khofshiya
חָפְשִׁית	khofshit
חֲצָאִית	khatsait
חֲצוֹצְרָה	khatsotsra
חֲצוֹת	khatsot
חֲצוֹת־הַלֵּיל	khatsot-haleyl
חֲצוֹת־הַלַּיְלָה	khatsot-halayla
חֵצִי	khetsi
חֲצִי־הַלַּיְלָה	khatsi-halayla
חָצִיל	chatsil
חָצִילִים	chatsilim
חֻצְפָּה	chutspa
חֻצְפָּה	khutspa
חֹק	khok
חִקָּה	khika
חֻקָּה	khuka
חֻקִּי	khuki
חַקְלָאוּת	khaklaut
חָקַק	khakak
חָקַר	khakar
חֵקֶר	kheker
חֵקֶר הַדָּגִים	kheker hadagim
חָרָא	hara
חָרַב	kharav
חֶרֶב	kherev
חֻרְבָּן	khurban
חֲרֵדִי	haredi
חֲרֵדִיוֹת	kharediot
חֲרֵדִיּוּת	kharediut
חֲרֵדִים	kharedim
חֲרֵדִית	kharedit
חָרוּב	kharuv
חָרוּת	kharut
חֵרוּת	kherrut
חֵרוּת	kherut
חַרְטוֹם	khartom
חָרִיף	kharif
חֵרֶם	herem
חֶרְמוֹן	khermon
חַרְמָן	kharman
חֶרֶס	kheres
חֲרֹסֶת	kharoset
חֹרֶף	khoref
חֳרָפִים	khorafim
חָרַץ	kharats
חֶרֶק	kherek
חָרַשׁ	kharash
חָרָשׁ	kharash
חֶרֶשׂ	kheres
חֶרֶשׁ	kheresh
חֵרֵשׁ	kheresh
חֹרֶשׁ	khoresh
חָרַת	charat
חָשׁ	khash
חַשָּׁב	khashav
חָשַׁב	khashav
חִשֵּׁב	khishev
ח־שׁ־ב	kh-sh-v
חֻשַּׁב	khushav
חֶשְׁבּוֹן	kheshbon
חֶשְׁבּוֹן אִינְפִינִיטֶסִימָלִי	kheshbon infinitesimali
חֶשְׁבּוֹן דִּיפֶרֶנְצְיָאלִי וְאִינְטֶגְרָלִי	kheshbon diferentsyali vintegrali
חָשׁוּב	khashuv
חָשׁוּד	khashud
חֶשְׁוָן	kheshvan
חֹשֶׁךְ	choshekh
חַשְׁמוֹנַאי	khashmonai
חַשְׁמַל	khashmal
חַשְׁמַלִּי	khashmali
חַשְׁמַלִּית	khashmalit
חַשְׁמָלִית	khashmalit
חַשְׁמָן	khashman
חָשַׂף	khasaf
חֵשֶׁק	kheshek
חָתוּל	khatul
חֲתוּלָה	khatula
חֲתוּלִים	khatulim
חָתוּל נְמֵרִי	khatul nmeri
חָתִיךְ	hatich
חֲתִיכָה	khatikha
חֲתִיכַת	hatichat
חֲתִימָה	khatima
חֲתָךְ	khatakh
חַתָּךְ	khatakh
חָתַךְ	khatakh
חֲתַלְתּוּל	khataltul
חָתָן	khatan
חֹתֵן	khoten
חֲתֻנָּה	khatuna
חֹתְנוֹ	chotno
טִאְטֵא	tite
טֻאְטָא	tuta
טַבָּח	tabakh
טָבַח	tavakh
טֶבַח	tevakh
טָבַל	taval
טֶבַע	teva
טִבְעִי	tivi
טַבַּעַת	tabaat
טְבֶרְיָה	tverya
טֵבֵת	tevet
טִגּוּן	tigun
טִגֵּן	tigen
טֻגַּן	tugan
טֶהֱרָאן	teheran
טֶהֱרָאנִי	teherani
טוֹב	tov
טוּב	tuv
טוֹבָה	tova
טוּבְיָּה	tuvya
טוואי המשי	tevay hameshi
טוֹטַל לוֹס	total los
טוּנְגְּסְטֶן	tungsten
טַוָּס	tavas
טוֹפּוֹלוֹגְיָה	topologya
טוֹרְסוֹ	torso
טוּרְקִי	turki
טוּרְקְיָה	turkya
טָחוּן	takhun
טָחַן	takhan
טְיוּטָה	tyuta
טִיּוּל	tiyul
טִיט	tit
טִיל	til
טִיֵּל	tiyel
טַיָּס	tayas
טַיִס	tayis
טִיסָה	tisa
טִיסוֹת	tisot
טִיפּ	tip
טִיפּוּס	tipus
טִירָה	tira
טֵי״ת	tet
טֵית	tet
טֶכְנוֹלוֹגִי	tekhnologi
טֶכְנוֹלוֹגְיָה	tekhnologia
טַל	tal
טְלָאִים	tlaim
טֶלֶגְרָף	telegraf
טִלְגְּרֵף	tilgref
טָלֶה	tale
טֶלֶוִיזְיָה	televizya
טֶלֶוִיזְיוֹת	televizyot
טִלְטֵל	tiltel
טֻלְטַל	tultal
טָלִין	talin
טַלִּית	talit
טַלִּיתוֹת	talitot
טֶלֶסְקוֹפּ	teleskop
טֵלֶסְקוֹפִּים	teleskopim
טִלְפֵּן	tilpen
טָמַן	taman
טֶמְפֶּרָטוּרָה	temperatura
טֶנִיס	tenis
טֶנִיסַאי	tenisai
טֶנִיס שׁוּלְחָן	tenis shulkhan
טֶנִיס שֻׁלְחָן	tenis shulkhan
טִנֵּף	tinef
טֻנַּף	tunaf
טַנְק	tank
טָס	tas
טֶסְט	test
טֶסְטוֹסְטֶרוֹן	testosteron
טָעָה	taa
טָעוּת	taut
טְעֻיּוֹת	tauyot
טָעִים	taim
טְעִימָה	tima
טַעַם	taam
טָעַם	taam
טַף	taf
טִפָּה	tipa
טִפּוּל	tipul
טִפּוּלִים	tipulim
טִפּוּס	tipus
טַפִּיל	tapil
טַפִּילִי	tapili
טֻפַּל	tupal
טֻפְּלוּ	tuplu
טִפֵּס	tipes
טֹפֶר	tofer
טֹפֶר	tofer
טִפֵּשׁ	tipesh
טֶקִילָה	tekila
טְרָאוּמָה	trauma
טְרָגֶדְיָה	tragedya
טְרָגִי	tragi
טְרוֹל	trol
טָרִי	tari
טֵרִי	terry
טְרִי	tri-
טְרִיבּוּנָה	tribunalt--maybe tribuna--gt
טְרִיָּה	triya
טרייה	triya
טְרִיפּ	trip
טָרַף	taraf
טִרְפֵּד	tirped
טָרָרָם	tararam
יָא	ya
יָאִיר	yair
יֵאָכֵל	yeachel
יֹאכַל	yochal
יַאלְלָה	yalla
יַאֲמִינוּ	yaaminu
יֵאָמַר	yeamar
יֹאמֶר	yomer
יֹאמְרוּ	yomru
יְאֹר	yor
יֹאשִׁיָּהוּ	yoshiyahu
יָבוֹא	yavo
יַבְעֶר	yaver
יִבְעַר	yivar
יְבַעֵר	yvaer
יָבֵשׁ	yavesh
י־ב־שׁ	y-b-sh
יִבֵּשׁ	yibesh
יַבָּשָׁה	yabasha
יַבֶּשֶׁת	yabeshet
יָד	yad
יַדְבֵּר	yadber
יְדַבֵּר	ydaber
יָדָה	yada
יָדָהּ	yadah
יָדוֹ	yado
יַדּוּ	yadu
יִדּוּעַ	yidua
יָדִיד	yadid
יָדִיד	ydidei
יְדִידוּת	ydidut
יְדִידוּתִי	ydiduti
יְדִידִים	ydidim
יָדֶיךָ	yadecha
יָדַיִם	yadayim
יְדִיעָה	ydia
יָדִית	yadit
יָדְךָ	yadcha
יְדָנִי	ydani
יָדַע	yada
יֶדַע	yeda
יִדֵּעַ	yidea
יֻדַּע	yuda
יָדַעְתִּי	yadati
יָהַב	yahav
יְהָב	yhav
יַהֲדוּת	yahadut
יַהֲדוּת חֲרֵדִית	yahadut kharedit
יַהֲדוּת קוֹנְסֶרְבָטִיבִית	yahadut konservativit
יְהוּדָה	yhuda
יְהוּדִי	yhudi
יְהוּדִים	yhudim
יְהוּדִית	yhudit
יהוה	yhvh
יְהוֹשֻׁעַ	yhoshua
יְהִי	yhi
יִהְיֶה	yihye
יָהִיר	yahir
־ָיו	-av, -aw
יוֹאָב	yoav
יוֹאֵל	yoel
יוֹבֵל	yovel
יוּבַל	yuval
יוֹגוּרְט	yogurt
יוֹ״ד	yod
יוֹד	yod
יוֹדֵעַ	yodea
יוֹחָנָן	yokhanan
יוּלִי	yuli
יוֹם	yom
יוֹם־הֻלֶּדֶת	yom-huledet
יוֹם טוֹב	yom tov
יוֹם שִׁשִּׁי	yom shishi
יוֹמוּלֶדֶת	yomuledet
יוֹמָן	yoman
יָוָן	yavan
יוֹן	yon
יוֹנָה	yona
יוֹנוֹסְפֶרָה	yonosfera
יוֹנִי	yoni
יוּנִי	yuni
יְוָנִי	yvani
יְוָנִית	yevanit
יְוָנִית	yvanit
יוֹנֵק	yonek
יוֹנַת	yonat
יוֹנָתָן	yonatan
יוֹסִי	yosi
יוֹסֵף	yosef
יוֹצֵא	yotse
יוֹצֵאת	yotset
יוֹרֵד	yored
יוֹרְדִים	yordim
יוֹרֶדֶת	yored
יוֹרֶדֶת	yoredet
יוֹרָה	yora
יוֹרֶה	yore
יוּרָה	yura
יוֹרֵשׁ	yoresh
יוֹשֵׁב	yoshev
יוֹשֶׁבֶת	yoshevet
־ִיּוֹת	-iyot
־ִיּוּת	-iyut
־ֻיּוֹת	-uyot
יוֹתֵר	yoter
יוֹתֵר מִדַּי	yoter miday
יָזִיז	yaziz
יָזְמָה	yozma
יֶזַע	yeza
יִחֵד	yikhed
יְחֶזְקֵאל	yekhezkel
יְחִי	ykhi
יְחִידָה	yehida
יַחַס	yakhas
יַחֲסֵי מִין	yakhasey min
יָחֵף	yakhef
יְיָ	yy
יִידִישׁ	yidish
יַיִן	yayin
יֵינוֹת	yenot
יְכוֹלֶת	ykholet
יַכְטָה	yakhta
יָכֹל	yakhol
יָכְלָה	yachla
יְכַלֶּה	ychale
יִכְלֶה	yichle
יָלַד	yalad
יֶלֶד	yeled
יַלְדָּה	yalda
יָלְדָה	yalda
יַלְדוּת	yaldut
יְלָדוֹת	yladot
יַלְדֵי	yalde
יַלְדִּי	yaldi
יִלְדֵי	yilde
יְלָדַי	yladay
יְלִדֵי	ylide
יְלָדִים	yladim
יַלֶּדְכֶן	yaledchen
יָלִיד	yalid
יְלִידֵי	ylidei
יַלֶּפֶת	yalefet
יָם	yam
יַם הַמֶּלַח	yam hamelakh
יַם סוּף	yam suf
יַמַּאי	yamai
יְמֵי הַבֵּינַיִם	ymei habeinayim
יַמִּים	yamim
יָמִים	yamim
יָמִים טוֹבִים	yamim tovim
יָמִין	yamin
יְמָמָה	yemama
יָנוּאָר	yanuar
יָנַק	yanak
יַנְקוּת	yanqut
יַנְשׁוּף	yanshuf
יַנְשׁוּפִים	yanshufim
יִסֵּד	yised
יְסוֹד	yesod
יִסּוּד	yisud
יַסְמִין	yasmin
יַעֲבִדוּ	yaavidu
יָעֶה	yae
יְעִילוּת	yilut
יָעִים	yaim
יָעֵל	yael
יָעֵל	yael
יִעֵל	yiel
יֹעַל	yoal
יַעֲנוּ	yaanu
יְעַנּוּ	yanu
יַעְנִי	yani
יַעֲקֹב	yaaqov
יַעַר	yaar
יַעֲשֶׂה	yaase
יֵּעָשֶׂה	yease
יָפֶה	yafe
יְפֵהפֶה	yfefe
יָפוֹ	yafo
יֹפִי	yofi
יַפָּן	yapan
יָפָּנִית	yapanit
יִפְרֶה	yifre
יִפְרֹץ	yifrots
יָצָא	yatsa
יֹצְאֵי	yotse
יָצוּק	yatsuk
יְצוּקָה	ytsuka
יִצְחַק	yitskhak
יִצְחָק	yitskhak, yishaq
יְצִיאָה	ytsia
יְצִיבוּת	ytsivut
יָצַר	yatsar
יֵצֶר	yetser
יָקוּם	yakum
יְקוּם	yekum
יִקּוֹם	yikom
יָקִינְתּוֹן	yakinton
יַקִּיר	yakir
יָקָר	yakar
יִקָּרֵא	yikare
יִקְרָא	yikra
יָרֵא	yare
יָרְאוּ	yaru
יֵרָאוּ	yerau
יִרְאוּ	yiru
יְראוּ	yru
יַרְבֶּה	yarbe
יִרְבֶּה	yirbe
יָרַד	yarad
יָרַד גֶּשֶׁם	yarad geshem
יַרְדֵּ֔ן	yarden
יָרָה	yara
יָרוּי	yarui
יְרוּשָׁלַיִם	yerushalayim
יְרוּשָׁלַ͏ִם	yrushalayim
יְרוּשָׁלֵם	yrushalem
יָרֵחַ	yareakh
יֶרַח	yerakh
יְרֵחִי	yrekhi
יְרָחִים	yrakhim
יֶרִי	yeri
יְרִידָה	yrida
יְרִיחוֹ	yrikho
יְרִיעָה	yeria
יָרֵךְ	yarekh
יִרְמְיָה	yirmya
יִרְמְיָהוּ	yirmyahu
יָרַק	yaraq
יָרָק	yaraq
יָרֹק	yarok
יָרֹק	yaroq
יֶרֶק	yereq
יַרְקָן	yarqan
יְרַקְרַק	yrakrak
יָרַשׁ	yarash
יְרֻשָּׁה	yrusha
יֵשׁ	yesh
יש;	yesh
יָשַׁב	yashav
יַשֵּׁב	yashev
יִשֵּׁב	yishev
י־שׁ־ב	y-sh-b
יַשְׁבָן	yashban
יֵשׁוּ	yeshu
יִשּׁוּב	yishuv
יִשּׂוּם	yisum
יֵשׁוּעַ	yeshua
יְשׁוּת	yeshut
יְשִׁיבָה	yshiva
יְשִׁיבוֹת	yshivot
יְשִׁיבַת	yshivat
יָשִׂימוּ	yasimu
יש ל־ ג׳וק בראש	yesh l- juk ba-rosh
יִשְׁמָעֵאל	yishmael
יִשְׁמְעוּ	yishmu
יִשְׁמְעוּן	yishmun
יָשָׁן	yashan
יָשֵׁן	yashen
יָשָׁן נוֹשָׁן	yashan noshan
יְשַׁעֲיָהוּ	ysaayahu
יָשָׁר	yashar
יֹשֶׁר	yosher
יִשְׂרָאֵל	yisrael
יִשְׂרְאֵלִי	yisreli
יִשְׂרְאֵלִיּוֹת	yisreliyot
יִשְׂרְאֵלִים	yisrelim
יִשְׂרְאֵלִית	yisrelit
יִשְׁרְצוּ	yishrtsu
יִשָּׂשכָר	yisakhar
יָתֵד	yated
יָתוֹם	yatom
יְתוֹמִים	ytomim
יִתֵּן	yiten
יֻתַּן	yutan
יֶתֶר	yeter
יִתְרוֹן	yitaron
כְּ־	k-
כָּאַב	kaav
כְּאֵב	keev
כְּאֵב רֹאשׁ	keev rosh
כָּאוּב	kauv
כְּאִלּוּ	kilu
כָּאן	kan
כַּאֲשֶׁר	kaasher
כָּבֵד	kaved
כִּבֵּד	kibed
כִּבָּה	kiba
כֻּבָּה	kuba
כָּבוֹד	kavod
כִּבּוּשׁ	kibush
כִּבְיָכוֹל	kivyakhol
כְּבִיסָה	kvisa
כְּבִישׁ	kvish
כְּבִישִׁים	kvishim
כִּבֵּס	kibes
כְּבָר	kvar
כָּבַשׁ	kavash
כֶּבֶשׂ	keves
כֶּבֶשׁ	kevesh
כַּד	kad
כְּדַאי	kdai
כַּדּוּר	kadur
כַּדּוּרֶגֶל	kaduregel
כַּדּוּרִים	kadurim
כַּדּוּר סַל	kadursal
כַּדּוּרְסַל	kadursal
כַּדּוּרְעָף	kaduraf
כַּדּוּר פּוֹרֵחַ	kadur poreakh
כְּדַי	kdai
כְּדֵי	kde
כֹּה	ko
כֵּהֶה	kehe
כֹּהֶל	kohel
כִּהֵן	kihen
כֹּהֵן‎	kohen
כֹּהֵן	kohen
כְּהֻנָּה	khuna
כֹּהַנִים‎	kohanim
כֹּהֶנֶת	kohenet
כּוֹבַע	kova
כּוֹבְעֵי־גֶּרֶב	kovaei-gerev
כּוֹבָעִים	kovaim
כִּוּוּן	kivun
כּוּזָרִים	kuzarim
כּוֹכָב	kokhav
כּוֹכְבֵי לֶכֶת	kochve lechet
כּוֹכַב יָם	kokhav yam
כּוֹכָבִית	kokhavit
כּוֹכַב לֶכֶת	kokhav lekhet
כּוֹלֵל	kolel
כּוֹלֶסְטֶרוֹל	kolesterol
כִּוֵּן	kiven
כַּוָּנָה	kavana
כּוֹנָן	konan
כּוֹנֵן	konen
כּוֹנָן קָשִׁיחַ	konan kashiakh
כּוֹס	kos
כּוּס	kus
כּוֹסוֹת	kosot
כּוּסְכּוּס	kuskus
כּוֹר	kor
כּוּר	kur
כַּוֶּרֶת	kaveret
כּוֹרֵת	koret
כּוֹרֵת עֵצִים	koret etsim
כּוּשׁ	kush
כּוּשִׁי	kushi
כּוֹתֵב	kotev
כָּזַב	kazav
כִּזֵּב	kizev
כָּזֶה	kaze
כְּזַיִת	kzayit
כֹּחַ	koach
כֹּחַ	koakh
כֹּחוֹת	kokhot
כָּחֹל	kahol
כְּחַלְחַל	kkhalkhal
כִי	chi
כִּי	ki
כ״י	k.y.
כִּידוֹן	kidon
כידון רובה	kidon rovee
כִּיּוֹר	kiyor
כִימְיָה	khimya
כַּיָּס	kayas
כִּיס	kis
כִּיֵּס	kiyes
כִּיסֵּא מַלְכוּת	kise malkhut
כֵּיף	keif
כֵּיצַד	keytsad
כָּךְ	kakh
כִּכֵב	kikhev
כָּכָה	kacha
כָּכָה־כָּכָה	kakha-kakha
כִּכָּר	kikar
כֹּל	kol
כָּלָא	kala
כֶּלֶא	kele
כֶּלֶב	kelev
כַּלְבָּה	kalba
כְּלָבוֹת	klavot
כֶּלֶב יָם	kelev-yam
כְּלָבִים	klavim
כֶּלֶב כְּנַעֲנִי	kelev kenaani
כְּלַבְלַב	klavlav
כְּלַבְלָבִים	klavlavim
כֶּלֶב נָהָר	kelev nahar
כַּלֶּבֶת	kalevet
כַּלָּה	kala
כָּלָה	kala
כִּלָּה	kila
כָּלוּא	kalu
כְּלוּב	kluv
כְּלוּם	klum
כְּלִי	kli
כְּלִי־דָּם	kli-dam
כְּלִי זַיִן	kli zayin
כְּלֵיזְמֶר	kleyzmer
כְּלִי טַיִס	kli tayis
כְּלִי נֶשֶׁק	kli nesheq
כְּלִי־רֶכֶב	kli-rekhev
כַּלְכָּלָה	kalkala
כַּלְכָּלִי	kalkali
כָּלַל	kalal
כְּלָל	klal
כַּלָּנִית	kalanit
כל עוד	kol od
כַּמָּה	kama
כָּמַהּ	kamah
כָּמֵהַּ	kameah
כְּמוֹ	kmo
כַּמּוּת	kamut
כְּמוֹת	kmot
כִּמְעַט	kimat
כֹּמֶר	komer
כַּמָּת	kamat
כֵּן	ken
כִּנָּה	kina
כִּנּוּי	kinui
כִּנּוֹר	kinor
כְּנִיסָה	knisa
כֶּנֶס	kenes
כִּנֵּס	khines
כְּנֵסִיָּה	knesia
כנסייות	knesiyot
כנסיית	knesiyat-
כְּנֶסֶת	kneset
כְּנַעַן	knaan
כְּנַעֲנִי	knaani
כְּנַעֲנִית	knaanit
כָּנָף	kanaf
כּנר	khanar
כַּנִּרְאֶה	kanire
כִּנֶּרֶת	kineret
כֵּס	kes
כִּסֵּא	kise
כִּסָּה	kisa
כִּסּוּי	kisui
כִּסּוּפִים	kisufim
כַּסְכּוּסִים	kuskusim
כִּסְלֵו	kislev
כֻּסֶּמֶת	kusemet
כֶּסֶף	kesef
כַּסְפּוֹמַט	kaspomat
כַּסְפִּי	kaspi
כַּסְפִּית	kaspit
כַּסְתָּ״ח	kastah
כַּעַס	kaas
כָּעַס	kaas
כְּעָסִים	kasim
כָּעֵת	kaet
כַּף	kaf
כָּ״ף	kaf
כַּף אַשְׁפָּה	kaf ashpa
כֵּף הַתִּקְוָה הַטּוֹבָה	kaf hatikva hatova
כָּפָּא	kappa
כָּפָה	kafa
כָּפָה	kafa past tense, kafa present tense
כַּפָּהּ	kapah
כִּפָּה	kipa
כָּפוּ	kafu
כָּפוּ	kafu
כַּפּוֹ	kapo
כָּפוּל	kaful
כְּפוּלָה	kfula
כְּפוּלוֹת	kfulot
כְּפוּלִים	kfulim
כְּפוֹר	kfor
כִּפּוּר	kipur
כַּפַּיִם	kapayim
כְּפִיר	kfir
כַּפִּית	kapit
כָּפַל	kafal
כֵּפֶל	kefel
כְּפָפָה	kfafa
כִּפְפַת אִגְרוּף	kiffat igruf
כְּפָר	kfar
כַּפָּרָה	kapara
כְּפַר סָבָא	kfar sava
כָּרָגִיל	ka-ragil
כָּרֶגַע	karega
כָּרָה	kara
כֵּרָה	kera
כְּרוּב	kruv
כְּרוּבִים	kruvim
כְּרוּכִית	krukhit
כַּרְטִיס	kartis
כַּרְטִיס אַשְׁרַאי	kartis ashrai
כַּרְטִיס בְּרָכָה	kartis bracha
כְּרִיכָה	krikha
כְּרִיסְטְמַס	kristmas
כָּרִישׁ	karish
כָּרִית	karit
כֶּרֶם	kerem
כַּרְמִיאֵל‎	karmiel
כַּרְמֶל	karmel
כָּרַע	kara
כָּרַת	karat
כְּשֶׁ־	kshe-
כִּשָּׁלוֹן	kishalon
כָּשֵׁר	kasher
כִּשָּׁרוֹן	kisharon
כַּשְׁרוּת	kashrut
כַּתָּב	katav
כָּתַב	katav
כְּתָב	ktav
כְּתֻבָּה	ktuba
כְּתַב יָד	ktav yad
כָּתוּב	katuv
כְּתוּבָה	ktuva
כְּתוּבִית	ktuvit
כְּתוֹבֶת	ktovet
כְּתִיב	ktiv
כְּתִיבָה	ktiva
כֹּתֶל	kotel
כָּתֹם	katom
כְּתַמְתַּם	ktamtam
כֻּתְנָה	kutna
כְּתֹנֶת	ktonet
כָּתֵף	katef
כֶּתֶר	keter
כִּתֵּר	kiter
כִּתַּת יוֹרִים	kitat-yorim
לֹא	lo
לֹּא בָּרָא הַשָּׂטָן	lo bara hasatan
לֵאָה	lea
לֶאֶהוֹב	leehov
לְאַחַר	lakhar
לְאַט	lat
לְאֹם	lom
לֹא מִדֻּבְשְׁךָ וְלֹא מֵעֻקְצְךָ	lo miduvshkha vlo meuktskha
לְאֻמִּי	lumi
לְאֻמִּיּוּת	lumiyut
לֵאמֹר	lemor
לְאָן	lan
לָאפָה	lafa
לְאַשֵׁר	lasher
לֵב	lev
לֵבָב	levav
לִבֵּב	libev
לְבָבוֹ	lvavo
לֶבֶד	leved
לְבַד	lvad
לִבּוֹ	libo
לִבְחוֹר	livkhor
לָבִיא	lavi
לְבִיָּא	lviya
לְבִיאָה	lvia
לְבִיבָה	leviva
לַבְלַב	lavlav
לִבְלֵב	livlev
לָבָן	lavan
לִבֵּן	liben
לֻבֵּן	luban
לְבַנְבַּן	lvanban
לַבָּנֶה	labane
לִבְנֶה	livne
לְבָנָה	lvana
לְבָנָה	lvana
לְבֵנָה	lvena
לְבָנוֹן	lvanon
לִבְנוֹת	livnot
לְבָנוֹת	lvanot
לֶבַנְטִינִי	levantini
לְבָנִים	lvanim
לְבֵנִים	lvenim
לִבְרוֹא	livro
לַבְּרִיאוּת	labriut
לְבָרֵךְ	lvarekh
לָבַשׁ	lavash
לְגַבֵּי	lgabei
לְגַלּוֹת	lgalot
לִגְלוֹת	liglot
לָגַם	lagam
לְגַמְרֵי	lgamre
לִגְנֹב	lignov
לְדַבֵּר	ldaber
לֵדָה	leda
לֵדָה	leida
לָדִינוֹ	ladino
לָדַעַת	ladaat
לָהּ	lah
לֶהָבָה	lehava
לְהִגָּמֵר	lhigamer
לְהוֹלִיד	lholid
לַהַט	lahat
לָהַט	lahat
לִהְיוֹת	lihyot
לְהַכְעִיס	lhakhis
לְהִלָּחֵם	lhilakhem
לַהֲלֹךְ	lahaloch
לָהֶם	lahem
לָהֶן	lahen
לְהַעֲלֹתוֹ	lhaaloto
לְהַפְרִיעַ	lhafria
לְהַצִּילוֹ	lhatsilo
לְהַצְלִיחַ	lhatsliach
לַהֲקָה	lahaka
לְהָרְגֵנִי	lhorgeni
לְהָרִיחַ	lhariakh
לְהַשְׁקוֹת	lhashkot
לְהִתְוַכֵּח	lhitvakeach
לְהִתְרָאוֹת	lhitraot
לוֹ	lo
לוּ	lu
לוּב	luv
לוֹבְּסְטֶר	lobster
לוֹגוֹ	logo
־לוֹגְיָה	-logya
לוֹד	lod
לוּד	lud
לוֹהֵט	lohet
לוּחַ	luakh
לוּחוֹת	lukhot
לוּחַ שָׁנָה	luakh shana
לֵוִי	levi
לְוִיִּם	lviyim
לַוְיָן	lavyan
לִוְיָתָן	livyatan
לוּל	lul
לוּלִין	lulin
לוּלְיָן	lulyan
לוֹנְדּוֹן	london
לְחַבֵּל	lkhabel
לְחִי	lekhi
לִחְיוֹת	likhyot
לְחַיִּים	lkhayim
לְחִימָה	lekhima
לֶחֶם	lekhem
לַחְמָנִיָּה	lakhmaniya
לַחַן	lakhan
לַחֲנוֹק	lakhanok
לְחַפֵּשׂ	lkhapes
לַחָץ	lakhatz
לָחַץ	lakhatz
לָחַשׁ	lakhash
לַחֲשׁוֹב	lachashov
'''לְטָאָה'''	ltaah
לַטְוִיָּה	latviya
לִטֵּף	litef
לִי	li
לִיבִּידוֹ	libido
לְיַד־	lyad-
לְיָד	lyad
לְיָדָהּ	lyada
לֵיְזֶר	leizer
לִיטָא	lita
לִיטָאִי	litai
לִיטָאִית	litait
לַיִל	layil
לֵיל	leil
לַיְלָה	layla
לַיְלָה טוֹב	laila tov
לֵילוֹת	leilot
לִימוֹן	limon
לִימוֹנָדָה	limonada
לִינְק	link
לִיסְבּוֹן	lisbon
לִירָה	lira
לֵית בְּרֵרָה	leyt berera
לִיתוֹגְרַפְיָה	litografia
לִיתְיוּם	lityum
לִכְבוֹד	likhvod
לִּכּוּד	likud
לִכּוּדְנִיק	likudnik
לכי	lach
לְכִי	lchi
לֵכִי	lechi
לִכְלוּךְ	likhlukh
לִכְלֵךְ	likhlekh
לְכָל שַׁבָּת יֵשׁ מוֹצָאֵי שַׁבָּת	lechol shabat yesh motzaei shabat
לָכֶם	lachem
לִכְתּוֹב	likhtov
לְלֹא	llo
לָלֶכֶת	lalekhet
לְ־, ל־, לִ־, לַ־, לֶ־, לָ־	l-, l-, li-, la-, le-, la-
לְ־, לִ־, לַ־, לֶ־, לָ־, לֵ־, לוֹ־	l-, li-, la-, le-, la-, le-, lo-
לְלַמֵּד	llamed
לָם	lam
לָמַד	lamad
לָמֶ״ד	lamed
לָמֶד	lamed
לִמֵּד	limed
לַמְדָנִי	lamdani
לָמָּה	lama
לָמָּה זֶה	lama ze
לְמוּאֵל	lmuel
לִמּוּד	limud
לִמּוּדִים	limudim
לֶמוּר	lemur
לְמִידָה	lmida
לְמַעְלָה	lmala
לְמַעַן	lmaan
לְמַעַן הַשֵּׁם	lemaan hashem
לַמְרוֹת	lamrot
לְמָשָׁל	lmashal
לָן	lan
לָן	lan
לָנוּ	lanu
לָנוּחַ	lanuakh
לִסְלוֹחַ	lisloakh
לְסַפֵּר	lsaper
לֶסֶת	leset
לַעֲבֹד	laavod
לָעַד	laad
לְעוֹלָם	lolam
לַעֲזָאזֵל	laazazel
לַעֲזוֹר	laazor
לָעַס	laas
לַעֲשׂוֹת	laasot
לְעִתִּים	leitim
לְעִתִּים קְרוֹבוֹת	leitim krovot
לְעִתִּים רְחוֹקוֹת	leitim rekhokot
לְעֵת עַתָּה	let ata
לְפָחוֹת	lfakhot
לְפִי־	lfi-
לַפִּיד	lapid
לְפִיו	lfiv
לִפְנֵי	lifnei
לִפְעָמִים	lifamim
'''לֶפֶת'''	lefet
לַק	laq
לֵק	leq
לָקָה	laka
לָקַח	lakakh
לֶקַח	lekakh
לְקַלְקֵל	lkalkel
לְקַנֵּא	lkane
לִקֵּק	likek
לֻקַּק	lukak
לֻקַּק	lukak
לִקְרַאת	likrat
לִרְאוֹת	lirot
לָרֶדֶת	laredet
לָרוּץ	laruts
לִרְחֹץ	lirchots
לָרִיב	lariv
לָשׁ	lash
לָשֶׁבֶת	lashevet
לְשַׁד	leshad
לָשׁוּב	lashuv
לָשׁוֹן	lashon
לָשׁוֹן הָרַע	lashon hara
לְשׁוֹנוֹת	lshonot
לְשַׁחְרֵר	lshakhrer
לְשַׁלְּחוֹ	lshalcho
לֶשֶׁם	leshem
לִשְׁמֹר	lishmor
לִשְׁתּוֹת	lishtot
לְתַרְגֵּם	ltargem
מִ־	mi-
מַאֲבָק	maavak
מְאֹד	mod
מַאֲדִים	maadim
מַאֲדִימִי	maadimi
מֵאָה	mea
מְאֹהָב	mohav
מַאֲהָל	maahal
מָאוֹר	maor
מְאַוְרֵר	mavrer
מְאוּשְׁכָּן	mushkan
מֵאוֹת	meot
מֵאָז	meaz
מְאֻחָד	mukhad
מְאֲחוֹרֵי	meakhorei
מְאֻחָר	mukhar
מַאי	may
מֵאַיִן	meayin
מֵאִיר	meir
מְאֻכְזָב	mukhzav
מַאֲכָל	maakhal
מְאֻכְלָס	mukhlas
מַאֲכֶלֶת	maakhelet
מְאַלֵּף	mealef
מְאֻלָּף	meulaf
מָאמִי	mami
מַאֲמָץ	maamats
מְאַמֵּץ	mamets
מְאֻמָּץ	mumats
מַאֲמָר	maamar
מְאֻנָךְ	meunakh
מָאַס	maas
מַאֲפִיָּה	maafiya
מַאֲפִיַּת	maafiyat
מְאֻשָּר	mushar
מְאֻשֶׁרֶת	musheret
מְאַת־	mat-
מָאתַיִם	matayim
מֵאִתָּנוּ	meiitanu
מְבֻגָּר	mevugar
מַבְדִּיל	mavdil
מְבוּכָה	mvukha
מַבּוּל	mabul
מְבוּשִׁים	mvushim
מִבְחָן	mivkhan
מַבָּט	mabat
מִבְטָא	mivta
מֵבִין	mevin
מְבֻיָּת	mvuyat
מְבַלְבֵּל	mvalbel
מְבֻלְבָּל	mvulbal
מִבְנֶה	mivne
מִבְצָע	mivtsa
מִבְצָר	mivtsar
מְבַקְשִׁים	mvakshim
מַבְרֵג	mavreg
מַבְרְגִים	mavrgim
מִבְרָשׁוֹת	mivrashot
מִבְרֶשֶׁת	mivreshet
מְבַשֵּׂר	mvaser
מָג	mag
מַגְבִּיל	magbil
מִגְבַּעַת	migbaat
מַגֶּבֶת	magevet
מֶגֶד	meged
מֻגָּד	mugad
מְגִדּוֹ	megido
מִגְדָּל	migdal
מֻגְדָּל	mugdal
מִגְדָּל בָּבֶל	migdal bavel
מִגְדָּלָהּ	migdalah
מִגְדָּר	migdar
מַגְהֵץ	maghetz
מְגַוֵּן	mgaven
מְגֻוָּן	mguvan
מִגְוָן	migvan
מגידי שיעור	magidei-shiur
מַגָּל	magal
מְגִלָּה	mgila
מָגֵן	magen
מָגֵן אֲשָׁכִים	magen ashakhim
מָגֵן בֵּיצִים	magen beytsim
מָגֵן דָּוִד	maen david
מַגְנֵט	magnet
מַגְנֵטִי	magneti
מַגְנֵטִיּוּת	magnetiut
מָגִנֵּי אֲשָׁכִים	maginei ashakhim
מַגְנִיב	magniv
מָגִנֵּי בֵּיצִים	maginei beytsim
מַגָּף	magaf
מִגְרָעָה	migraa
מַדְאִיג	madig
מְדַבֵּר	mdaber
מִדְבָּר	midbar
מְדַבֶּרֶת	mdaberet
מַדְגֵּשׁ	madgesh
מַדָּד	madad
מָדַד	madad
מַדְהִים	madhim
מַדּוּעַ	madua
מְדוּרָה	medura
מַדְחֹם	madhom
מָדַי	maday
מִדַּי	miday
מִדֵּי	midey
מִדְיָן	midyan
מָדִינָה	madina
מְדִינָה	mdina
מְדִינוֹת	mdinot
מְדִינַת	mdinat
מַדָּע	mada
מַדָּעִי	madai
מַדְּעֵי הַרוּחַ	madei ha-ruach
מַדְעָן	madan
מַדָּף	madaf
מַדְפֶּסֶת	madpeset
מַדְרֵגָה	madrega
מַדְרֵגוֹת	madregot
מַדְרִיד	madrid
מַדְרִיךְ	madrikh
מִדְרָכָה	midrakha
מִדְרָשׁ	midrash
מָה	ma
מְהַגֵּר	mhager
מַהוּ	mahu
מָהִיר	mahir
מְהִירוֹת	mhirot
מְהִירוּת	mhirut
מַה יֵּשׁ;	ma yesh
מַה לַּעֲזָאזֵל	ma laazazel
מְהַנְדֵּס	mhandes
מְהַנְדְּסֵי	mhandse
מְהַנְדְּסִים	mhandsim
מַה נִּשְׁמַע	ma nishma
מה עניין שמיטה אצל הר סיני	ma inyan shmita etzel har sinay
מַהְפֵּכָה	mahpekha
מַהֵר	maher
מִהֵר	miher
מִהַרְתֶּן	miharten
מַה שְּׁלוֹמֵךְ	ma shlomekh
מַה שְּׁלוֹמְךָ	ma shlomkha
מוֹאָב	moav
מוֹבִיל	movil
מוּבָן	muvan
מוּגְל	mugl
מוּגְלְגִים	muglgim
מוֹדִיעִין עִלִּית‎	modiin ilit
מוֹדֶם	modem
מוֹדָעָה	modaa
מוֹדַעַת אֵבֶל	modaat evel
מוֹדֶרְנִי	moderni
מוֹדֶרְנִית	modernit
מוֹהֵל	mohel
מוּזִיקָה	muzika
מוזיקות	muzikot
מוזיקת	muzikat-
מוּזָר	muzar
מוֹט	mot
מוּטָב	mutav
מוֹטֵט	motet
מוּכָן	mukhan
מוֹכֵר	mokher
מוֹל	mol
מוּל	mul
מוֹלֶדֶת	moledet
מוּם	mum
מוֹנוֹתֵאִיזְם	monoteizm
מוֹנוֹתֵאִיסְטִי	monoteisti
מוֹנִיּוֹת	moniyot
מוֹנִיטִין	monitin
מוֹנִית	monit
מוּסִיקָה	musika
מוֹסְקְבָה	moskva
מוֹעֲדוֹן	moadon
מוֹצִיא	motzi
מוֹקֵשׁ	mokesh
מוֹרֵד	mored
מוֹרֶה	more
מוֹרַי וְרַבּוֹתַי	moray vrabotay
מוֹרִים	morim
מוֹרְפֶאוּס	morfeus
מוֹשָׁב	moshav
מוּשְט	musht
מוֹשִׁיעַ	yashayah
מָוֶת	mavet
מוּת	mut
מָזַג	mazag
מֶזֶג	mezeg
מִזֵּג	mizeg
מֻזַּג	muzag
מֶזֶג־אֲוִיר	mezeg-avir
מַזְגָן	mazgan
מְזֹהָם	mzoham
מִזּוּג	mizug
מִזְוָדָה	mizvada
מְזוּזָה	mzuza
מְזוּזוֹת	mzuzot
מָזוֹן	mazon
מֵזַח	mezakh
מְזֻיָּף	mezuyaf
מַזְכִּיר	mazkir
מַזְכִּירִים	mazkirim
מַזָּל	mazal
מַזְלֵג	mazleg
מְזֻמָּן	mezuman
מְזַמֵּן	mzamen
מְזֻמָּן	mzuman
מְזַעֲזֵעַ	mzaazea
מְזֻעְזָע	mzuza
מְזֻקָּן	mzukan
מִזְרָח	mizrakh
מֹחַ	moakh
מַחְבּוֹא	makhbo
מַחְבֵּט	makhbet
מְחַבֵּל	mkhabel
מַחְבָּר	makhbar
מֶחְבָּר	mekhbar
מִחְבָּר	mikhbar
מְחַבֵּר	mkhaber
מְחֻבָּר	mkhubar
מַחְבֶּרֶת	makhberet
מַחֲבַת	makhavat
מָחוֹג	makhog
מֶחֱוָה	mekheva
מָחוֹז	makhoz
מְחוֹזוֹת	mkhozot
מְחוֹזִי	mkhozi
מַחֲזֶה	makhaze
מַחְזוֹר	makhzor
מַחְזוֹרִי	makhzori
מַחֲזֶמֶר	makhazemer
מַחַט	makhat
מְחֻיָּב	mkhuyav
מְחִיקוֹן	mekhikon
מְחִיר	mkhir
מְחִירִים	mchirim
מַחְלָבָה	makhlava
מַחֲלָה	makhala
מֻחְלָט	mukhlat
מַחְלָקָה	makhlaka
מַחְלֹקֶת	makhloket
מַחְמָד	makhmad
מֻחַמַּד	mukhammad
מַחְמִיר	makhmir
מְחֻמָּשׁ	mkhumash
מַחֲנֶה	makhane
מחנה ריכוז	mahane-rikkuz
מַחֲנַיִם	makhanayim
מַחְסָן	makhsan
מֹחַ עֶצֶם	moah etzem
מְחֻפָּשׂ	mkhupas
מְחֻפָּשׁ	mkhupash
מַחַק	makhak
מָחַק	makhak
מֶחְקָר	mekhkar
מֶחְקָרִים	mechkarim
מָחָר	makhar
מָחָר כָּךְ	makhar kakh
מָחֳרָתַיִם	mokhoratayim
מַחְשֵׁב	machshev
מַחְשָׁבָה	makhshava
מַחְשְׁבוֹן	makhshvon
מַחֲשָׁבוֹת	makhshavot
מְחֻתָּן	mkhutan
מַחְתֶּרֶת	makhteret
מִטְבָּח	mitbakh
מִטְבָּחִים	mitbakhim
מַטְבֵּעַ	matbea
מִטְבָּעָה	mitbaa
מַטְבֵּעַ חוּץ	matbea khuts
מַטְבֵּעַ לָשׁוֹן	matbea lashon
מטֻגָּן	mtugan
מַטָּה	mata
מַטֶּה	mate
מִטָּה	mita
מָטוֹס	matos
מַטּוֹת	matot
מִטּוֹת	mitot
מָטָח	matakh
מַטָּלָה	matala
מְטַמְטֵם	mtamtem
מִטְמָנָה	mitmana
מַטְעֵן	maten
מִטְעָן	mitan
מְטֻפָּל	mtupal
מָטַר	matar
מָטָר	matar
מַטָּרָה	matara
מִטְרִיָּה	mitriya
מִטַּת	mitat
מֵי	me
מִי	mi
מְיַבֵּשׁ	meyabesh
מְיֻבָּשׁ	myubash
מְיַבֵּשׁ כְּבִיסָה	meyabesh kvisa
מְיַבֵּשׁ שֵׂעָר	meyabesh sear
מְיַבֵּשׁ שֵׂעָר	meybesh sear
מִיָּד	miyad
מִיָּד	miyad
מִיָּדִי	miyadi
מֵידָע	meida
מִיהוּ	mihu
מִיּוּן	miyun
מָיוֹנֶז	mayonez
מֵיזָם	meizam
מיזמים	meizamim
מְיֻזָּע	myuza
מְיֻחָד	myuchad
מְיֻחָד	myukhad
מֵי חַמְצָן	me chamtsan
מִיכָאֵל	mikhael
מִיכָה	mikha
מִיכָיָה	mikayah
מִיכָיְהוּ	mikayhu
מֵיכָל	meikhal
מִיכַל	mikhal
מֵילָא	meila
מְיַלְּדוֹת	myaldot
מְיַלֶּדֶת	myaledet
מִילָה	mila
מִילְיַארְד	miliard
מִילָנוֹ	milano
מַיִם	mayim
מִימוּשׁ	mimush
מֵימֵי	meme
מֵימָן	meiman
מְיֻמָּן	meyuman
מִין	min
מִינִי	mini
מִינִיּוּת	miniyut
מִינִימָלִי	minimali
מִינְסְק	minsk
מֵינֶקֶת	meineket
מִינֵרָלוֹגְיָה	mineralogya
מְיַסֵּד	myased
מְיֻפֶּה־כֹּחַ	myupe-koakh
מִיץ	mits
מִיקָה	mika
מִיקְרוֹאוֹרְגָּנִיזְם	mikroorganizm
מִיקְרוֹפוֹן	mikrofon
מִישֶׁהוּ	mishehu
מִישִׁיגֶן	mishigen
מַכְאוֹב	makhov
מַכְאִיב	makhiv
מַכַּבִּי	makabi
מַכַּבִּים	makabim
מְכַבִּים	mchabim
מַכָּה	maka
מַכֶּה	make
מֶכָּה	meka
מָכוֹן	makhon
מְכוֹנָה	mkhona
מְכוֹנוֹת	mkhonot
מְכוֹנִית	mkhonit
מכונת	mkhonat-
מְכוֹנַת גִּלּוּחַ	mekhonat giluakh
מְכוֹנַת כְּבִיסָה	mekhonat kvisa
מְכוֹנַת כְּתִיבָה	mekhonat ktiva
מַכּוֹת	makot
מֵכִיל	mekhil
מְכִירָה	mkhira
מְכִירָה פֻּמְבִּית	mkhira pumbit
מַכְלֵב	makhlev
מִכֹּל וָכֹל	mikol vachol
מִכְלוֹל	mikhlol
מִכְלָלָה	mikhlala
מַכֹּלֶת	makolet
מֶכָנִיקָה	mekhanika
מֶכָנִיקָה קְלָסִית	mekhanika klasit
מֶכָנִיקַת	mekhanikat
מֶכָנִיקַת הַשֶּׁבֶר	mekhanikat hashever
מִכְנָסַיִם	mikhnasayim
מָכַר	makhar
מֻכָּר	mukar
מָכְרָה	machra
מִכְרָה	michra
מִכְרָהּ	michrah
מִכְרֶה	michre
מַכְשִׁיר	makhshir
מְכַשֵּׁף	mekhashef
מֻכְשָׁר	mukhshar
מַכַּת	makat
מִכְתָּב	mikhtav
מִכְתָּבִים	mikhtavim
מָלֵא	male
מִלֵּא	mile
מֻלָּא	mula
מַלְאָךְ	malakh
מְלָאכָה	mlakha
מְלָאכוּתִי	melakhuti
מַלְאֲכֵי	malakhe
מַלְאָכִי	malkhi
מַלְאָכִים	malachim
מַלְבֵּן	malben
מִלְגָּה	milga
מִלָּה	mila
מִלָּה	milla
מַלּוּחַ	maluakh
מָלוּחַ	maluakh
מְלוּכָה	mlukha
מָלוֹן	malon
מֶלוֹן	melon
מִלּוֹן	milon
מִלּוֹנִים	milonim
מַלָּח	malakh
מֶלַח	melakh
מִלְחָמָה	milkhama
מִלְחֶמֶת	milkhemet
מַלְטָה	malta
מלטזי	maltezi
מִלִּים	milim
מִלִּית	milit
מָלַךְ	malakh
מֶלֶךְ‏	melekh
מַלְכָּה	malka
מִלְכָּה	milka
מַלְכוּת	malkhut
מְלָכוֹת	mlachot
מַלְכֵי	malkhei
מְלָכִים	mlakhim
מַלְכִּי-צֶדֶק	malki-tsedek
מְלֻכְלָךְ	mlukhlakh
מַלְכַּת	malkat
מַלְכַּת אֶסְתֵּר	malkat ester
מִלְּכַתְּחִלָּה	milkhatkhila
מַלְמָד	malmad
מְלַמֵּד	mlamed
מִלְּעֵיל	milel
מְלָפְפוֹן	mlaffon
מְלָפְפוֹן יָם	mlaffon yam
מֶלְצַר	meltsar
מלצרים	miltzarim
מֶלְצַרִית	meltsarit
מָלַרְיָה	malarya
מִלְּרַע	milra
מֵ״ם	mem
מֵם	mem
מֶם	mem
מָמוֹן	mamon
מִמּוּן	mimun
מַמְזֵר	mamzer
מֻמְחֶה	mumkhe
מַמְלָכָה	mamlakha
מַמְלֶכֶת	mamlekhet
מֻמְלָץ	mumlats
מִמֶּנּוּ	mimenu
מַמְצִיא	mamtsi
מְמֻצָּע	mmutsa
מַמָּשׁ	mamash
מַמְשִׁיךְ	mamshikh
מֶמְשָׁלָה	memshala
מֶמְשָׁלוֹת	memshalot
ממשלת	memshelet
מָן	man
מִן	min
מַנְגּוֹ	mango
מַנְגִּינָה	mangina
מַנְדּוֹלִינָה	mandolina
מָנָה	mana
מָנֶה	mane
מִנְהָג	minhag
מַנְהִיג	manhig
מְנַהֵל	menahel
מְנַהֶלֶת	menahelet
מְנוּחָה	mnukha
מָנוֹעַ	manoa
מְנוֹרָה	mnora
מְנוֹרוֹת	mnorot
מַנְחֶה	manhe
מִנְחָה	minha
מְנַחֵם	mnachem
מִנַּיִן	minayin
מִנְיָן	minyan
מְנִיפָה	menifa
מָנַע	mana
מַנְעוּל	manul
מְנֻקָּד	mnukad
מְנַשֶּׁה	menashe
מְנַתֵּחַ	menateakh
מְנֻתָּק	mnutak
מַס	mas
מְסִבָּה	msiba
מְסִבַּת עִתּוֹנָאִים	msibat-itonaim
מִסְגָּד	misgad
מְסֻגָּל	msugal
מְסֻגָּלִים	msugalim
מִסְגֶּרֶת	misgeret
מִסְדְּרוֹן	misdron
מַסּוֹק	masok
מַסְטוּל	mastul
מַסְטִיק	mastik
מְסִילַּת בַּרְזֶל	msilat barzel
מִסִּים	misim
מְסֻיָּם	msuyam
מְסִירָה	msira
מְסֻכָּן	msukan
מַסֶּכֶת	masekhet
מַסְלוּל	maslul
מְסֻנְוָר	msunvar
מְסַנֶּנֶת	msanenet
מַסָּע	masa
מִסְעָדָה	misada
מִסְעָדָוֹת	misadot
מַסְפִּיק	maspik
מִסְפָּר	mispar
מִסְפֵּר	misper
מְסַפֵּר	msaper
מֻסְפַּר	muspar
מִסְפָּרָה	mispara
מִסְפָּרִי	mispari
מִסְפָּרַיִם	misparayim
מִסְפָּרִים	misparim
מַס קְנִיָּה	mas kniya
מָסַר	masar
מֶסֶר	meser
מָסֹרֶת	masoret
מָסֹרֶת	masoret
מָסָרְתִּי	masorti
מְסַרְתֵּן	msarten
מִסְתּוֹר	mistor
מַעֲבָּדָה	maabada
מַעֲבָר	maavar
מְעֻבָּר	mubat
מַעְבֹּרֶת	maboret
מְעֻבֶּרֶת	muberet
מַעְגָּל	maagal
מַעֲגָנָה	maagana
מָעֳדָף	moodaf
מַעֲדֵר	mader  maader
מְעוֹדֵד	moded
מעות חטים	maot itim
מְעַט	mat
מעט מדי, מאוחר מדי	mat midai, mukhar midai
מַעֲטָפָה	maatafa
מְעִיל	mil
מְעִילָה	mila
מַעְיָן	maayan
מָעַל	maal
מֵעַל	meal
מַעֲלָה	maala
מַעֲלִיב	maaliv
מַעֲלִית	maalit
מֻעֲמָד	muamad
מְעַנְיֵן	manyen
מְעֻנְיָן	munyan
מְעֻנָּן	munan
מַעֲצָר	maatsar
מַעֲקָב	maakav
מַעֲקֶה	maake
מַעֲרָב	maarav
מַעֲרָבוֹן	maaravon
מְעָרָה	mara
מַעֲרוֹךְ	maarokh
מַעֲרִיב	maariv
מַעֲרָכָה	maarakha
מַעַרְכוֹן	maarkhon
מַעֲרָכוֹת	maarachot
מַעֲרֶכֶת&lt;--x--&gt;־&lt;--x--&gt;הַפְעָלָה	maarekhet-hafala
מַעֲרֶכֶת	maarekhet
מַעֲרֶכֶת מְבֻדֶּדֶת	maarekhet mvudedet
מַעֲרֶכֶת סְגוּרָה	maarekhet sgura
מַעֲרֶכֶת פְּתוּחָה	maarekhet ptukha
מערכת שמש	maarekhet-shemesh
מַעַשׂ	maas
מַעֲשֶׂה	maase
מַעֲשֵׂר	maaser
מַפַּא״י	mapai
מַפַּאי	mapai
מְפִבֹשֶׁת	mfiboshet, mpiboset
מַפְגִּין	mafgin
מִפְגָּשׁ	mifgash
מִפְגָּשִׁים	mifgashim
מַפָּה	mapa
מַפּוּחַ	mapuakh
מַפּוֹת	mapot
מַפְטִיר	maftir
מְפִיבֹשֶׁת	mpiboset
מַפִּית	mapit
מִפְלָגָה	miflaga
מַפְלִיא	mafli
מִפְלֶצֶת	mifletset
מִפְּנֵי־	mipnei-
מַפְסִידָן	mafsidan
מְפֻסְפָּס	mfuspas
מִפְעָל	mifal
מְפַקֵּד	mfaked
מִפְקָדָה	mifkada
מְפֻרְסָם	mfursam
מִפְרָץ	mifrats
מִפְרָשׂ	mifras
מִפְשָׂעָה	mifsaa
מַפַּת	mapat
מַפְתֵּחַ	mafteakh
מָצָא	matsa
מַצָּב	matsav
מַצַּב רוּחַ	matsav ruakh
מַצָּה	matsa
מצה עשירה	matza ashira
מִצְוָה	mitsva
מְצַוָּה	mtsava
מְצַוֶּה	mtsave
מְצַוֶּה	mtsave
מְצֻוֶּה	mtsuve
מִצְווֹת	mitsvot
מַצּוֹת	matsot
מִצְוַת־	mitsvat-
מִצְוַת הַקְהֵל	mitsvat hak-hel
מִצְוֹתָיו	mitsvotav
מַצְחִיק	matskhik
מְצֻיָּן	mtsuyan
מְצֻיָּן	mtzuyan
מְצִיצָה	metsitsa
מֻצְלָח	mutzlakh
מֻצְלַחַת	mutzlakhat
מַצְלִיחַ	matzliakh
מַצְלֵמָה	matzlema
מָצַץ	matsats
מֵצַר	meitsar
מִצְרִי	mitsri
מִצְרַיִם	mitsrayim
מִצְרַיְמָה	mitsrayma
מִצְרִית	mitsrit
מִצְרִיֹּת	mitzriyot
מַקְבִּיל	makbil
מַקְדֵּחָה	makdekha
מֻקְדָּם	mukdam
מִקְדָּשׁ	mikdash
מַקְהֵלָה	makhela
מִקְוֶה	mikve
מָקוֹם	makom
מְקוֹמוֹת	mkomot
מְקוֹמִי	mkomi
מַקּוֹר	makor
מָקוֹר	makor
מְקֻטָּל	mkutal, mquttal
מַקִּיף	makif
מַקֵּל	makel
מָקֵל	makel
מִקְלֶדֶת	mikledet
מִקְלַחַת	miklakhat
מַקְלֵט	maklet
מִקְלָט	miklat
מְקֻלְקָל	mkulkal
מִקֵּם	mikem
מֶקְסִיקוֹ	meksiko
מַקָּף	makaf
מֻקָּף	mukaf
מִקְצוֹעַ	miktsoa
מִקְרָא	mikra
מִקְרֶה	mikre
מְקָרֵר	mkarer
מֻקַּשׁ	mukash
מַר	mar
מֹר	mor
מַרְאָה	mara
מַרְאֶה	mare
מַרְאוֹת	marot
מַרְאִית עַיִן	marit ayin
מֵרַב	merav
מָרַד	marad
מֶרֶד	mered
מָרְדֳּכַי‏‏‏	mordechay or mordechay
מָרָה	mara
מָרוֹם	marom
מָרַח	marakh
מָרִיחוּאָנָה	marikhuana
מִרְיָם	miryam
מְרִיצָה	mritsa
מֶרְכָּב	merkav
מֶרְכָּבָה	merkava
מֶרְכָּז	merkaz
מֶרְכָּזִי	merkazi
מַרְס	mars
מַרְפֵּא	marpe
מַרְפֵּא פֶּלֶא	marpe pele
מִרְפֶּסֶת	mirpeset
מַרְפֵּק	marpek
מֶרֶץ	merets
מֶרְץ	merts
מְרֻצֶּה	mrutse
מַרְצִיפָּן	martsipan
מָרָק	marak
מִרְשָׁם	mirsham
מְרֻשָּׁת	merushat
מַשְׁאֵבָה	masheva
מַשָּׂאִית	masait
מֻשָּׂג	musag
משגיח רוחני	mashgiakh rukhani
מְשֻׁגָּע	mshuga
מְשֻׁגָּע	mshuga
מֹשֶׁה	moshe
מַשְׁהַד	mashhad
מַשֶּׁהוּ	mashehu
מִשְׁוָאָה	mishvaa
מַשּׂוֹא פָּנִים	maso panim
מָשׁוֹט	mashot
מְשׁוֹרֵר	meshorer
מָשׂוֹשׂ	masos
מָשַׁח	mashakh
מִשְׂחָק	miskhak
מִשְׂחַק וִידֵאוֹ	miskhak video
מִשְׂחֲקֵי וִידֵאוֹ	miskhakei video
מִשְׂחָקִים	miskhaqim
מִשְׂחֲקֵי מַחְשֵׁב	miskhakei makhshev
מִשְׂחַק מַחְשֵׁב	miskhak makhshev
מִשְׁטָרָה	mishtara
מָשִׁיחַ	mashiakh
מְשִׁיכָה	meshikha
מְשִׂימָה	mesima
מָשַׁךְ	mashakh
מֶשֶׁךְ	meshekh
מִשְׁכָּן	mishkan
מְשַׁכְנֵעַ	mshakhnea
מַשְׂכֹּרֶת	maskoret
מָשַׁל	mashal
מָשָׁל	mashal
משלוחי מנות	mishlokhei-manot
מִשְׁלַח יָד	mishlakh yad
מַשְׁלִים	mashlim
מְשָׁלִים	mshalim
מֻשְׁלָם	mushlam
מְשֻׁלָּשׁ	meshulash
מַשְׁמִין	mashmin
מַשְׁמָע	mashma
מִשְׁמֵעַ	mishmea
מַשְׁמָעוּת	mashmaut
מַשְׁמָעִי	mashmai
מִשְׁמֶרֶת	mishmeret
מִשְׁמֵשׁ	mishmesh
מִשְׁנָה	mishna
מִשְׁנֶה	mishne
מְשַׁנָּה	mshana
מְשַׁנֶּה	mshane
מְשֻׁנֶּה	mshune
מְשֻׁנּוֹת	mshunot
מִשְׁנָיוֹת	mishnayot
מְשֻׁנִּים	mshunim
מְשִׁסָּה	mshisa
מְשֻׁעְבָּד	mshubad
מִשְׁפָּחָה	mishpakha
מִשְׁפָּחוֹת	mishpakhot
מִשְׁפַּחַת	mishpakhat
מִשְׁפַּחְתִּי	mishpakhti
מִשְׁפָּחְתִּי	mishpakhti
מִשְׁפָּט	mishpat
משפטים	mishpatim
מְשֻׁפָּע	mshupa
מַשְׁקֶה	mashke
מְשָׁקִים	meshakim
מִשְׁקָל	mishkal
מִשְׁקָפַיִם	mishkafayim
מִשְׂרָד	misrad
מִשְׁתֶּה	mishte
מִשְׁתָּלָה	mishtala
מִשְׁתַּמֵּשׁ	mishtamesh
מִשְׁתָּנָה	mishtana
מִשְׁתַּנֶּה	mishtane
מְשֻׁתָּף	mshutaf
מֵת	met
מֵת	met
מִתְאַגְרֵף	mitagref
מִתְאָר	mitar
מְתָאֵר	mtaer
מִתְגַּיֵּס	mitgayes
מֵתוּ	metu
מֶתוֹדָה	metoda
מְתַוֵּךְ	metavech
מִתּוֹךְ	mitokh
מָתוֹק	matok
מָתַי	matai
מַתִּי	mati
מְתֻיָּר	mtuyar
מַתִּירָנוּת	metiranut
מַתְכּוֹן	matkon
מַתְכֹּנִים	matkonim
מְתֻכְנָן	mtukhnan
מָתֵמָטִיקָה	matematika
מָתֶמָטִיקָה	matematika
מַתָּן	matan
מִתֵּן	miten
מַתַּן תּוֹרָה	matan tora
מַתָּנָה	matana
מְתֹעָב	mtoav
מֹתֶק	motek
מִתְקַדְּמִים	mitkadmim
מְתַרְגֵּם	mtargem
מְתֻרְגָּם	mturgam
מְתֻרְגְּמָן	mturgman
מַתִּתְיָהוּ	matityahu
נָא	na
נֶאֱבַד	neevad
נֶאֱבַק	neevak
נֶאֱגַר	neegar
נָאֶה	nae
נֶאֱהַב	neehav
נֶאֱהַד	neehad
נָאוָה	nava
נָאוֶה	nave
נֵאוֹן	neon
נָאוֹר	naor
נֶאֱחַז	neekhaz
נָאִיבִי	naivi
נֶאֱכַל	neekhal
נֶאֱכַף	neekhaf
נֶאֱמַן	neeman
נֶאֱמָן	neeman
נֶאֱמָנוּת	neemanut
נָאַף	naaf
נֶאֱצָל	neetsal
נָאקָה	naka
נִבָּא	niba
נִבָּא	niba
נִבֵּא	nibe
נִבֵּא	nibe
נֻבָּא	nuba
נִבְדַּק	nivdak
נָבּוּ	nabu
נְבוֹ	nvo
נָבוֹן	navon
נָבַח	navakh
נִבְחַר	nivkhar
נִבְחָר	nivkhar
נָבִיא	navi
נְבִיאִים	nviim
נָבַל	naval
נָבָל	naval
נֵבֶל	nevel
נְבֵלָה	nveila
נִבְנָה	nivne
נִבְרָא	nivra
נֶגֶב	negev
נַגָּד	nagad
נָגַד	nagad
נֶגֶד	neged
נָגַהּ	nagah
נֹגַהּ	nogah
נִגּוּן	nigun
נִגְזֶרֶת	nigzeret
נְגִיף	nagif
נִגְלָה	nigla
נִגְמַר	nigmar
נִגֵּן	nigen
נִגְנַב	nignav
נָגַע	naga
נַגָּר	nagar
נִגַּשׁ	nigash
נֹגְשָׂיו	nogsav
נָדַד	nadad
נִדָּה	nida
נְדוּדִים	ndudim
נְדוּנְיָה	ndunya
נִדּוֹת	nidot
נִדְחָה	nidkha
נִדְחֲתָה	nidkhata
נָדִיר	nadir
נָדָל	nadal
נָדָן	nadan
נִדְרַס	nidras
נִדַּת	nidat
נַהָג	nahag
נָהַג	nahag
נֶהֱדָר	nehedar
נֶהֱנָה	nehena
נָהַר	nahar
נָהָר	nahar
נֶהֱרַג	neherag
נֶהֱרַס	neheras
נוֹבֶמְבֶּר	november
נוֹגְדָן	nogdan
נוגה	nogah
נוּגֶה	nuge
נוֹדַע	noda
נוֹזֵל	nozel
נוֹחַ	noakh
נ־ו־ח	n-w-h  n-h
נַוְטָן	navtan
נוֹלַד	nolad
נוּ״ן	nun
נוּן	nun
נוֹסַד	nosad
נוֹסֵעַ	nosea
נוֹסָף	nosaf
נוֹף	nof
נוֹצְרִי	notsri
נוּר	nur
נוֹרָא	nora
נוֹרָא	nora
נוֹרְבֶגְיָה	norvegya
נוֹרָה	nora
נוּרָה	nura
נוֹשֵׂא	nose
נוֹשֶׁה	noshe
נִזְבְּחָה	nizbcha
נִזְהָר	nizhar
נָזִיד	nazid
נָזִיר	nazir
נִזְכַּר	nizkar
נֵזֶר	nezer
נִזַּר	nizar
נָח	nakh
נָח	nakh
נֹחַ	noakh
נַחוּם	nakhum
נַחַ״ל	nakhal
נַחַל	nakhal
נָחַל	nakhal
נֶחְלַשׁ	nekhlash
נֶחֱמַד	nekhemad
נֶחְמָד	nekhmad
נְחֶמְיָה	nehemia
נַחְמָן	nakhman
נֶחְקַק	nekhkak
נֶחְקַר	nekhkar
נַחַשׁ	nakhash
נָחָשׁ	nakhash
נִחֵשׁ	nichesh
נִחֵשׁ	nikhesh
נֶחְשַׁב	nekhshav
נְחֹשֶׁת	nkhoshet
נַחַת	nakhat
נָחַת	nakhat
נָחֵת	nakhet
נֶחָת	nekhat
נָטָה	nata
נָטוּי	natuy
נְטִיָּה	ntiya
נָטַל	natal
נֵטֶל	netel
נִטֵּל	nitel
נָטַע	nata
נֶטַע	neta
נִיב	niv
נַיָּד	nayad
נַיָּדִים	nayadim
נְיוּ זִילַנְד	nyu ziland
נְיוּ יוֹרְק	nyu york
נְייַר עֲטִיפָה	niyar atifa
נִינְגָ׳ה	ninja
נִיסָן	nisan
'''נִיעֵר'''	nier
־נִיק	-nik
נְיָר	nyar
נְיָרוֹת	nyarot
נְיָר לַקְמוּס	nyar lakmus
נֶכֶד	nekhed
נֶכְדָּה	nekhda
נָכֶה	nakhe
נִכָּה	nika
נָכוֹן	nakhon
נִכּוּר	nikoor
נִכְלַל	nikhlal
נִכְלַם	nikhlam
נִכְנַס	nikhnas
נכנס יין יצא סוד	nikhnas yayin yatsa sod
נֵכָר	nekhar
נִכָּר	nikar
נִכַּר	nikar
נִכֵּר	niker
נ־כ־ר	n-k-r
נָכְרִי	nokhri
נִכְתַּב	nikhtav
נִלְחַם	nilkham
נֵלְכָה	nelcha
נִלְקַח	nilkakh
נָם	nam
נִמְאַס	nimas
נָמוּךְ	namuch
נִמְחַק	nimkhak
נִמְכַּר	nimkar
נָמֵל	namel
נְמַל־הַתְּעוּפָה	nmal-hatufa
נִמְלַט	nimlat
נִמְלַךְ	nimlakh
נִמְנַע	nimna
נָמַס	namas
נִמְצָא	nimtsa
נָמֵר	namer
נְמֵרָה	nmera
נִמְרוֹד	nimrod
נֶמֶשׁ	nemesh
נִמְשַׁךְ	nimshakh
נִמְשָׁךְ	nimshakh
נַנָּס	nanas
נַנָּס לָבָן	nanas lavan
נָס	nas
נֵס	nes
נֵס	nes
נִסְגַּר	nisgar
נִסָּה	nisa
נֻסָּה	nusa
נָסוּךְ	nasukh
נֻסָּח	nusakh
נֻסְחָה	nuskha
נִסְחַף	niskhaf
נִסָּיוֹן	nisayon
נָסִיךְ	nasikh
נְסִיכָה	nesikha
נְסִיכוּת	nsikhut
נִסִּים	nisim
נִסִּים	nisim
נְסִיעָה	nsia
נָסַע	nasa
נָע	na
נָעִים	naim
נָעִים מְאוֹד	naim mod
נְעִימָה	neima
נְעִימוֹן	neimon
נַעַל	naal
נָעַל	naal
נְעָלֶיךָ	nalecha
נֶעֱלַם	neelam
נָעֳמִי	noomi
נַעְנַע	nana
נִעְנֵעַ	ninea
נֶעֱצַר	neetsar
נַעַר	naar
נָעַר	naar
נַעֲרָה	naara
נְעָרִים	narim
נַעֲרֹתֶיהָ	naaroteha
נַעֲשָׂה	naasa
נַעֲשֶׂה	naase
נִפְגַּע	nifga
נִפְגַּשׁ	nifgash
נָפָה	nafa
נָפוּחַ	nafuakh
נֶפטוּן	neptun
נִפְטַר	niftar
נָפִיל	nafil
נְפִילָה	nfila
נָפַל	nafal
נִפְלָא	nifla
נִפֵּץ	nipets
נִפְצַע	niftsa
נִפְרַד	nifrad
נִפְרָד	nifrad
נָפַשׁ	nafash
נֶפֶשׁ	nefesh
נֹפֶשׁ	nofesh
נִפְשַׁט	nifshat
נָפַת	nafat
נִצָּב	nitsav
נִצּוֹל	nitsol
נִצּוּל	nitsul
נֵצַח	netzakh
נֶצַח	netzakh
נִצֵּחַ	nitseakh
נִצָּחוֹן	nitsakhon
נִצַּל	nitsal
נִצֵּל	nitsel
נִצָּן	nitzan
נָצַר	natsar
נֵצֶר	netser
נִצֵּר	nitser
נִצְרָה	nitsra
נַצְרוּת	natsrut
נָצְרַת	natsrat
נָצְרַת עִלִּית‎	natsrat ilit
נְקֵבָה	nkeva
נִקְבַּר	nikbar
נְקֻדָּה	nekuda
נְקֻדָּה	nkuda
נְקֻדָּה וּפְסִיק	nkuda ufsik
נִקּוּד	nikud
נָקִי	naki
נְקָמָה	nekama
נִקְרָא	nikra
נִקְרָה	nikra
נִקְרַת	nikrat
נֵר	ner
נִרְאָה	nira
נִרְאֶה	nire
נַרְגִּילָה	nargila
נִרְגַּע	nirga
נֵרוֹת	nerot
נִרְטַב	nirtav
נִרְצַח	nirtsakh
נִרְצָח	nirtsakh
נַרְתִּיק	nartik
נַרְתִּיקִים	nartikim
נָשָׂא	nasa
נָשָׁא	nasha
נִשָּׂא	nisa
נִשֵּׂא	nise
נָשָׂא וְנָתַן	nasa vnatan
נִשְׁאַר	nishar
נִשְׁבָּה	nishba
נִשְׁבַּע	nishba
נִשְׁבַּר	nishbar
נָשׂוּא	nasu
נִשּׂוּאִין	nisuin
נָשׂוּי	nasui
נְשׁוֹת־	nshot-, nsot-
נִשְׁטַף	nishtaf
נָשִׂיא	nasi
נְשִׂיאוּת	nsiut
נְשִׂיאִים	nsiim
נְשִׁיכָה	neshikha
נָשִׁים	nashim
נָשִׂים	nasim
נְשִׁימָה	neshima
נְשִׁיפָה	neshifa
נְשִׁיקָה	neshika
נִשְׁכַּח	nishkakh
נִשְׂכַּר	niskar
נִשְׁלַט	nishlat
נָשַׁם	nasham
נָשְׁמָה	nashma
נְשָׁמָה	nshama
נִשְׁמַע	nishma
נִשְׁמַר	nishmar
נָשַׁמְתִּי	nashamti
נִשְׁמָתִי	nishmati
נָשַׁק	nashaq
נֶשֶׁק	nesheq
נִשֵּׁק	nishek
נ־שׁ־ק	n-sh-q
נֶשֶׁק גַּרְעִינִי	neshek garini
נֶשֶׁר	nesher
נִשְׂרַף	nisraf
נִתַּאי	nitay
נַתָּב	natav
נִתּוּחַ	nituakh
נִתְחַכְּמָה	nitchakma
נָתִיב	nativ
נָתַן	natan
נָתָן	natan
נִתַּן	nitan
נְתַנְיָה	ntanya
נְתַנְיָהוּ	ntanyahu
ס׳	siman
סָב	sav
סַב	sav
סַבָּא	saba
סָבַב	savav
סַבַּבָּה	sababa
סָבָה	sabba
סִבָּה	siba
סִבּוּב	sibuv
סִבּוּבִים	sibuvim
סִבּוּךְ	sibukh
סְבִיבָה	sviva
סְבִיבָהּ	svivah
סְבִיבוֹן	svivon
סְבִיבוֹנִים	svivonim
סְבִיבוֹת	svivot
סְבִירוּת	svirut
סִבִּית	sibit
סָבַל	saval
סַבְלָנוּת	savlanut
סַבְּרֶה	sabre
סְבָרָה	svara
סָבְתָא	savta
סָגַד	sagad
סֶגוֹל	segol
סָגוּר	sagur
סָגֹל	sagol
סְגַלְגַּל	sgalgal
סְגֻלָּה	sgula, sgulla
סִגְנוֹן	signon
סַגְסֹגֶת	sagsoget
סָגַר	sagar
סְדוֹם	sdom
סִדּוּר	sidur
סָדִין	sadin
סדינים	sdinim
סְדֹם	sdom
סַדָּן	sadan
סַדְנָא	sadna
סַדְנָה	sadna
סָדַר	sadar
סֵדֶר	seder
סִדֵּר	sider
סִדְרָה	sidra
סוּבּוֹתְניק	subotnik
סוֹבְלָנוּת	sovlanut
סִוֵּג	siveg
סוּג	sug
סֻוַּג	suvag
סוּגָה	suga
סוּג שֶׁל	sug shel
סוֹד	sod
סוֹל	sol
סוֹלְלָה	solla
סוּנִי	suni
סוּס	sus
סוּסַיִם	susayim
סוּס יַם	sus yam
סוֹף	sof
סוּף	suf
סוֹף סוֹף	sof sof
סוֹפִי	sofi
סוֹפִית	sofit
סוֹפֵר	sofer
סוּפֶּר	super
סוּפֶּרְפּוֹזִיצְיָה	superpozitsya
סוֹצְיָאלִיזְם	sotsyalizm
סוּרְיָה	surya
סוּשִׁי	sushi
סְחוֹרָה	skhora
סָחַט	sakhat
סְטוּדֶנְט	student
סְטָטִיסְטִיקָה	statistika
סְטִירָה	stira
סְטִירוֹת	stirot
סְטִירַת	stirat
סְטֶנְדְּאָפּ	stendap
סְטֶנְדְאַפִּיסְט	stendapist
סִיבִּיר	sibir
סִיגְד	sigd
סִיגַרְיָה	sigarya
סִידָן	sidan
סַיְדֶּר	saider
סִיּוּט	siyut
סִיּוּם	siyum
סִיוָן	sivan
סִיֵּם	siyem
סִימֶטְרִי	simetri
סִימָן	siman
סִימָן־מוּלָד	siman-mulad
סִימָנִים	simanim
סִין	sin
סִינַי	sinay
סִינִי	sini
סִינִית	sinit
סִינְתֵּטִי	sinteti
סִיסְמָה	sisma
סִיעָה	sia
סַיִף	sayif
סִירָה	sira
סִכָּה	sika
סִכּוּי	sikui
סַכּוּ״ם	sakum
סְכוּם	skhum
סֻכּוֹת	sukot
סְכִיזוֹפְרֶנְיָה	skizofrenya
סַכִּין	sakin
סַכִּין גִּלּוּחַ	sakin giluakh
סַכִּין יַפָּנִי	sakin yapani
סָכָל	sakhal
סֶכֶל	sekhel
סִכֵּל	sikel
סֻכַּל	sukal
סְכֶמָה	skhema
סִכֵּן	siken
סַכָּנָה	sakana
סָכַר	sakhar
סֶכֶר	sekher
סֻכָּר	sukar
סֻכְּרָזִית	sukrazit
סֻכֶּרֶת	sukeret
סָלוֹן	salon
סָלַח	salakh
סָלָט	salat
סְלִיחָה	slikha
סָלַל	salal
סֻלָּם	sulam
סַלְמוֹן	salmon
סְלֶנְג	sleng
סַם	sam
סַם פֶּלֶא	sam pele
סְמוֹל טוֹק	smol tok
סָמֶ״ךְ	samekh
סַמָּל	samal
סֵמֶל	semel
סַמְמָן	samman
סִמֵּן	simen
סְנָאִי	snai
סֶנְדְוִיץ׳	sendvich
סַנְדָּל	sandal
סַנְהֶדְרִין‎	sanhedrin
סָנַט	sanat
סֶנְט	sent
סֶנְט פֶּטֶרְסְבּוּרְג	sent petersburg
סַנְטֵר	santer
סניפים	snifim
סִנְכְּרֵן	sinkren
סֻנְכְּרַן	sunkren
סְנַפִּיר	snapir
סְנַפִּירִים	snapirim
סַנְקְצְיָה	sanktsya
סְעִיף	seif
סְעָרָה	seara
סָפַג	safag
סֻפְגָּנִיָּה	sufganiya
סֻפְגָּנִיָּה	sufganiya
סֻפְגָּנִיּוֹת	sufganiyot
סֻפְגָּנִית	sufganit
סָפַד	safad
סַפָּה	sapa
סְפּוֹדִיק	spodik
סִפּוּחַ	sipuach
סִפּוּר	sipur
סְפּוֹרְטַאי	sportai
סֶפְּטֶמְבֶּר	september
סְפִינָה	sfina
סָפִיר	safir
סַפִּיר	sapir
סְפִירָה	sfira
סְפִירוֹת	sfirot
סַפְסָל	safsal
סָפֵק	safek
סַפָּק	sapak
סִפֵּק	sipek
סְפֵקוֹת	sfekot
סָפַר	safar
סַפָּר	sapar
סֵפֶר	sefer
סִפֵּר	siper
סֵפֶר בְּרֵאשִׁית‎	sefer breshith
סֵפֶר בִּשׁוּל	sefer bishul
סְפָרַד	sfarad
סְפָרַדִּי	sfaradi
סְפָרַדִּית	sfaradit
סַפְרָה	safra
סְפֶרָה	sfera
סִפְרָה	sifra
סִפְּרָה	sipra
סְפָרוֹת	sfarot
סִפְרוּת	sifrut
סִפְרִיָּה	sifriya
סְפָרִים	sfarim
סֵפֶר לִמּוּד	sefer limud
סְצֵנָה	stzena
סֶקְסוּאָלִי	seksuali
סֶקְסִי	seksi
סָקַר	sakar
סַקְרָן	sakran
סִקְרֵן	sikren
סַקְרָנוּת	sakranut
סֵרַב	serav
סֶרְבּוֹ־קְרוֹאָטִית	serbo-kroatit
סַרְגֵּל	sargel
סֶרֶט	seret
סֶרֶט דְּיוֹ	seret dyo
סֶרֶט מַגְנֵטִי	seret magneti
סַרְטַן	sartan
סִרְטֵן	sirten
סַרְטַן הַדָּם	sartan ha-dam
סַרְטַן יָם	sartan yam
סָרַק	sarak
סָרָק	sarak
סְרָק	srak
סְתָו	stav
סָתוּם	satum
סְתִירָה	stira
סָתַם	satam
סֶתֶם	setem
סְתָם	stam
סְתָ״ם	stm, stam
סְתָמִי	stami
סְתָמִי	stami
עָב	av
עָבַד	avad
עֶבֶד	eved
עָבְדָה	avda
עַבְדָּהּ	avdah
עֲבֹדָה	avoda
עֲבֻדָּה	avuda
עִבְּדָה	ibda
עֻבְדָּה מֻגְמֶרֶת	uvda mugmeret
עַבְּדוּ	abdu
עֲבָדוֹ	avado
עַבְדּוֹ	avdo
עָבְדוּ	avdu
עִבְּדוּ	ibdu
עִבְדוּ	ivdu
עֲבָדִים	avadim
עֲבָדְךָ	avadcha
עַבְדְּךָ	avdcha
עֲבַדְתֶּם	avadtem
עֲבֹדָתָם	avodatam
עִבַּדְתֶּם	ibadtem
עֲבוֹדָה	avoda
עֲבוֹט	avot
עֲבוּר	avur
עָבַר	avar
עָבָר	avar
עֲבֹר	avor
עֵבֶר	erev
עֵבֶר	ever
עֲבָרָה	avara
עֲבֵרָה	avera
עֶבְרָה	evra
עִבְרוּת	ivrut
עִבְרִי	ivri
עִבְרִי	ivri
עִבְרִים	ivrim
עִבְרִית	ivrit
עִבְרִיֹּת	ivriyot
עַגְבָנִיָּה	agvaniya
עַגְבָנִיּוֹת	agvaniyot
עָגוּר	agur
עֻגוֹת	ugot
עֵגֶל	egel
עָגַן	agan
עֹגֶן	ogen
עַד	ad
עֵד	ed
עָדָה	ada
עֵדָה	eda
עֵדוּת	edut
עֵדִים	edim
עֲדַיִן	adayin
עָדִיף	adif
עֲדִיפוּיוֹת	adiyfuyot
עֲדִיפוּת	adiyfut
עַד כָּאן	ad kan
עַדֶּן	aden
עֵדֶן	eden
עֹדֶף	odef
עָדַר	adar
עֵדֶר	eder
עֲדָשָׁה	adasha
עוֹבַדְיָה	ovadia
עוּגָה	uga
עוּגִיָּה	ugia
עוֹד	od
עוֹדֵד	oded
עוֹדֵף	odef
עוֹכֵר שִׂמְחָה	okher simkha
עַוְלָה	avla
עוֹלָה	ola
עוֹלֶה	ole
עוֹלָם	olam
עוֹלָמִי	olami
עוֹלָמִית	olamit
עוֹמֵד	omed
עוֹנָה	ona
עוֹף	of
עִוֵּר	iver
עוֹר	or
עוֹרֵב	orev
עוֹרְבָנִי	orvani
עוֹרוֹת	orot
עוֹרֵךְ	orekh
עוֹרֵךְ דִּין	orekh din
עוֹרֶכֶת דִּין	orekhet din
עוֹרֵר	orer
עַז	az
עֵז	ez
עֲזָאזֵל	azazel
עָזַב	azav
עֲזַבְתֶּן	azavten
עַזָּה	aza
עָזַר	azar
עֵזֶר	ezer
עֶזְרָא	ezra
עֶזְרָה	ezra
עֵט	et
עָטָה	ata
עֲטִיפָה	atifa
עָטַף	ataf
עֲטָרָה	atara
עַיִט	ayit
עַיִ״ן	ayin
עַיִן	ayin
עִיֵּן	iyen
עָיַף	ayaf
עָיֵף	ayef
עִיֵּף	iyef
עִיר	ir
עֵירוֹם	erom
עִירוֹנִי	ironi
עִירִיָּה	iriya
עַכָּבִישׁ	akavish
עַכְבָּר	akhbar
עַכְבָּרִים	akhbarim
עַכּוֹ	ako
עַכּוּז	akuz
עִכּוּל	ikul
עַכְשָׁו	akhshav
עֲכְשָׁוִי	akhshavi
עֲכְשָׁוִית	akhshavit
עַל	al
עַל	al
עַל אָחַת כַּמָּה וְכַמָּה	al akhat kama vkhama
עָלָה	ala
עָלֶה	ale
עָלוּב	aluv
עֲלוּקָה	aluka
עָלַז	alaz
עָלֵז	alez
עַל טַעַם וְרֵיחַ אֵין לְהִתְוַכֵּחַ	al taam vreakh en lhitvakeach
עֲלֵי	alei
עֵלִי	eli
עֲלִיָּה	aliya
עָלָיו	alav
עֲלֵיכֶם שָׁלוֹם	aleikhem shalom
עָלִים	alim
עָלֵינוּ	alenu
עַל כֵּן	al ken
עַל־כֵּן	al-ken
עַל לֹא דָבָר	al lo davar
עֶלֶם	elem
עֹלָם	olam
עֻלָּם	ulam
עַלְמָה	alma
עַלְמָה	alma
עַל־פִּי	al pi
עַל רֶגֶל אַחַת	al regel achat
עַם	am
עִם	im
עָמַד	amad
עֶמְדָּה	emda
עַמּוֹ	amo
עִמּוֹ	imo
עַמּוּד	amud
עמוד בית	amud-bayit
עֲמוּדֵי בַיִת	amude vayit
עַמּוּדִים	amudim
עָמוֹס	amos
עַמִּי	ami
עִמִּי	imi
עֲמִידָה	amida
עַמִּים	amim
עָמִית	amit
עִמָּנוּאֵל	imanuel
עָמַק	amak
עָמֹק	amok
עֵמֶק	emek
עֹמֶק	omek
עֹמֶר	omer
עַמְרָם	amram
עֵנָב	einav
עֲנָבָה	anava
עִנְבָּל	inbal
עֹנֶג	oneg
עֹנֶג	oneg
עָנָה	ana
עֲנִי	ani
עָנִי	ani
עֹנִי	oni
עניין של זמן	inyan shel zman
עָנְיָם	onyam
עִנְיָן	inyan
עָנָן	anan
עֲנָנִים	ananim
עָנָף	anaf
עֲנָק	anak
עֲנָקִי	anaki
עַנֹּתוֹ	anoto
עָסוּק	asuk
עִסּוּק	isuk
עִסְקִי	iski
עָף	af
עֲפִיפוֹן	afifon
עַפְעַף	afaf
עָפָר	afar, apar
עָפֹר	afor
עֹפֶר	ofer
עֹפֶר	ofer
עַפְרָה	afra
עִפָּרוֹן	iparon
עֶפְרוֹנוֹת	efronot
עֵץ	etz
עֵץ אוֹ פָּלִי	etz o pali
עָצָה	atsa
עָצֶה	atse
עֵצָה	eitsa
עָצוּב	atsuv
עִצּוּב	itsuv
עָצוּם	atsum
עִצּוּר	itsur
עֵצִים	etsim
עַצְלָן	atslan
עַצְלָנִים	atslanim
עָצַם	atsam
עֶצֶם	etsem
עַצְמָאוּת	atsmaut
עָצַר	atsar
עָקֵב	akev
עֵקֶב	ekev
עֲקִיבָא	akiva, aqiba
עָקַף	akaf
עָקַץ	akats
עָקַר	akar
עִקָּר	ikar
עַקְרָב	akrav
עַקְרַבִּים	akrabim
עַקְשָׁן	akshan
עַקְשָׁנוּת	akshanut
עֵר	er
עֲרָב	arav
עָרַב	arav
עָרֵב	arev
עֶרֶב	erev
עֲרָבָה	arava
עֲרָבוֹת	aravot
עֲרֵבוּת	arevut
עַרְבוּת	arvut
עֶרֶב טוֹב	erev tov
עַרְבֵי	arve
עֲרָבִיָּה	araviya
עַרְבַּיִם	arbayim
עֲרָבִית	aravit
עַרְבִית	arvit
עֵרוּב	eiruv
עָרוּךְ	arukh
עָרוּם	arum
עָרוּץ	aruts
עֲרִיכָה	arikha
עֲרִיכוֹת	arikhot
עָרִים	arim
עָרַךְ	arakh
עֵרֶך	erekh
עֹרְכֵי־דִין	orkhe din
עָרַל	aral
עָרֵל	arel
עֲרֵלָה	arela
עָרְלָה	orla
עָרְלָה	orla
עָרְלַת	orlat
עָרֹם	arom
עַרְמוֹן	armon
עַרְסָל	arsal
עַרְעָר	arar
עֲרָפֶל	arafel
עַרַק	araq
עָרַק	araq
עֶרֶשׂ	eres
עָשׁ	ash
עֵשֶׂב	esev
עָשָׂה	asa
עָשָׂה חַיִל	asa hayil
עָשָׂה כְּבִיסָה	asa kvisa
עֲשׂוּ	asu
עָשׂוּ	asu
עֵשָׂו	esav, esaw
עִשּׁוּן	ishun
עָשִׁיר	ashir
עֲשִׂירִי	asiri
עֲשִׂיתֶן	asiten
עָשָׁן	ashan
עִשֵּׁן	ishen
עִשֵּׁן	ishen
עֶשֶׂר	eser
עֹשֶׁר	osher
עֹשֶׁר	osher
עֲשָׂרָה	asara
עִשָּׂרוֹן	isaron
עֶשְׂרִים	esrim
עֲשֶׂרֶת הַדִּבְּרוֹת	aseret hadibrot
עֵת	et
עַתָּה	ata
עִתָּהּ	itah
עִתּוֹן	iton
עִתּוֹנָאוּת	itonaut
עִתּוֹנַאי	itonai
עִתּוֹנָאִי	itonai
עִתּוֹנַאי	itonai
עִתּוֹנָאִי	itonaiy
עָתִיד	atid
עֲתִידִי	atidi
עַתִּיק	atik
עָתֵק	atek
עֹתֶק	otek
פָּאָה	paa
פֵּאָה	pea
פַּאי	pai
פְּאֵר	peer
פֵּאֵר	peer
פֶבְּרוּאָר	februar
פִּגּוּעַ	pigua
פִּגְיוֹן	pigyon
פָּגִיעַ	pagia
פְּגִיעָה	pgia
פְּגִישָׁה	pgisha
פָּגַע	paga
פֶּגַע	pega
פָּגַשׁ	pagash
פִּדְיוֹן	pidyon
פָדִיחָה	fadikha
פָה	fa
פֶּה	pe
פֹּה	po
פּוֹזָה	poza
פוּטֶר	futer
פּוּלֶט	polet
פּוֹלִיגְרָף	polygraf
פּוֹלִיטִי	politi
פּוֹלִיטִיקָה	politika
פּוּנְדָק‎	pundak
פּוֹעֵל	poel
פּוֹעֶלֶת	poelet
פּוּצָּה	putsah
פּוֹצֵץ	potsets
פוֹרוּם	forum
פּוּרִים	purim
פּוּרִים	purim
פוֹרְמָלִי	formali
פּוֹרְנו	porno
פּוֹרְנוֹגְרָפִי	pornografi
פּוֹרְנוֹגְרַפְיָה	pornografya
פּוֹרֵץ	poretz
פָּז	paz
פִּזְמוֹן	pizmon
פַּח	pakh
פַּחַד	pakhad
פָּחַד	pakhad
פִּחֵד	pikhed
פַּחְדָן	pakhdan
פָּחוֹת	pakhot
פֻּחְלָץ	pukhlatz
פֶּחָם	pekham
פַּחְמָן	pakhman
פָּטוּר	patur
פִּטּוּר	pitur
פְּטוֹר	ptor
פָּטוּר אֲבָל אָסוּר	patur aval asur
פַּטִּישׁ	patish
פֶּטֶל	petel
פִּטְמָה	pitma
פטמות	ptamot
פָּטַר	patar
פֶּטֶר	peter
פִּטֵּר	piter
פֻּטַּר	putar
פֶּטְרוֹזִילְיָה	petrozilya
פִּטְרִיָּה	pitriya
פִי	fi
פַּי	pay
פִּי	pi
פִּיהוּ	pihu
פִּיו	piv
פִיזִי	fizi
פִיזְיוֹלוֹגְיָה	fizyologya
פִּיךְ	pich
פִּיךָ	picha
פִּיל	pil
פִּילֶגֶשׁ	pilegesh
פִּילַגְּשִׁים	pilagshim
פִילָדֶלְפִיָּה	filadelfia
פִילוֹסוֹף	filosof
פִּילוֹסוֹף	pilosof, pilosop
פִּין	pin
פִּינְג פּוֹנְג	ping pong
פִּינִים	pinim
פִינְלַנְד	finland
פִּיצָה	pitsa
פיקוח נפש	pikuakh nefesh
פִּירוֹטֶכְנִיקָה	pirotekhnika
פִּירָמִידָה	piramida
פַּךְ	pakh
פֶּלֶא	pele
פָלָאפֶל	falafel
פֶּלֶג	peleg
פְּלָג	plag
פְּלָדָה	plada
פְלוּאוֹר	fluor
פלוּטוֹ	pluto
פָלוּס	falus
פֻּלְחָן	pulkhan
פֻּלְחָנִי	pulkhani
פְּלַטְפוֹרְמָה	platforma
פָלִי	fali
פָּלִינְדְּרוֹם	palindrom
פְלִירְטוּט	flirtut
פְּלִישָׁה	plisha
פְלָמִינְגּוֹ	flamingo
פָלַסְטִין	falastin
פְּלָסְטִיק	plastik
פְּלַסְטֶר	plaster
פִּלְפּוּל	pilpul
פִּלְפֵּל	pilpel
פִּלְפֵּל	pilpel
פִּלְפְּלים	pilplim
פִּלְפֵּל לָבָן	pilpel lavan
פִּלְפֵּל שָׁחֹר	pilpel shachor
פְלֶשׁ	flesh
פָּלַשׁ	palash
פְּלִשְׁתִּי	plishti
פְּלִשְׁתִּים	plishtim
פֶן	fen
פָּן	pan
פֶּן	pen
פֻּנְדָּק	pundak
פָּנָה	pana
פִּנָּה	pina
פָּנוּי	panuy
פִּנּוּי	pinui
פָּנוּיָה	panuya
פְּנֵי־	pnei-
פָּנִים	panim
פְּנִימָה	pnima
פָּנָס	panas
פַּנְצֶ׳ר	pancher
פִנֵּק	pinek
פִּנְקָס	pinkas
פָּסוּק	pasuk
פָּסַח	pasach
פֶּסַח	pesach
פִּסֵּחַ	piseach
פִסֵּחַ	piseach
פַּסְחָא	paskha
פִּסְּחִים	piskhim
פֹּסְחִים	poskhim
פְּסָחִים	psachim
פְּסִיכוֹלוֹג	psikholog
פְּסִיכוֹלוֹגְיָה	psikhologya
פְּסִיכִיאָטְרִי	psikhiatri
פַּסָּל	pasal
פָּסַל	pasal
פֶּסֶל	pesel
פִּסֵּל	pisel
פַּסֶּלֶת	paselet
פְּסֹלֶת	psolet
פְּסֹלֶת	psolet
פְּסַנְתֵּר	psanter
פְּסַנְתֵּרִים	psanterim
פִּסְפֵּס	pispes
פָּסַק	pasak
פָּסֵק	pasek
פִּסֵּק	pisek
פְּסָק	psak
פֻּסַּק	pusak
פִּסְקָה	piska
פָּעִיל	pail
פְּעִילוֹת	pilot
פְּעִילוּת	pilut
פָּעַל	paal
פִּעֵל	piel
פֹּעַל	poal
פֹּעַל	poal
פֻּעַל	pual
פְּעֻלּה	pula
פְּעָלִים	pealim
פַּעַם	paam
פָּעַם	paam
פִּעֵם	piem
פַּעֲמוֹן	paamon
פַּעֲמוֹנִים	paamonim
פָּפִּירוּס	papirus
פָּצִיפִיזְם	patsifizm
פֶּצַע	petza
פְּצָצָה	petzatza
פְּצָצָה אֲטוֹמִית	petzatza atomit
פָּקַד	pakad
פִּקֵּד	piked
פָּקַדְתִּי	pakadti
פָּקַח	pakach
פֶּקַח	pekach
פִּקֵּחַ	pikeach
פָּקִיד	pakid
פָּקַק	pakak
פְּקָק	pkak
פְּקָקִים	pkakim
‎פַּר‎	par
פַּרְבָּר	parbar
פָּרָג	parag
פֶּרֶג	pereg
פָּרָדִיגְמָה	paradigma
פַּרְדֵּ״ס	pardes
פַּרְדֵּס	pardes
פָּרָה‎	para
פָּרָה	para
פָּרוֹ	paro
פָּרוּ	paru
פְּרוֹ־	pro-
פְּרוּ	pru
פְּרוֹבִּיּוֹטִיקָה	probiyotika
פְּרוֹבִינְצְיָה	provintsya
פַּרְוָה	parva
פְּרוֹזְבּוֹל	prozbol
פְּרוֹטֶקְצְיָה	protektzya
פְּרוֹיֶקְט	proyekt
פרויקטים	proyektim
פְּרוּסָה	prusa
פְּרוֹפֶסוֹר	profesor
פָּרוֹת	parot
פֵּרוֹת	perot
פָּרַח	parakh
פֶּרַח	perakh
פְרֵחָה	frekha
פְּרָחִים	prakhim
פְּרָט	prat
פְּרָטֵי־	prate-
פְּרָטִי	prati
פְּרִי	pri
פֶּ‏רִיגֵיאָ‏ה	perigea
פָּרִיז	pariz
פָּרִים	parim
פְרָיֶר	fraier
פַּרְלָמֶנְט	parlament
פַרְמָקוֹלוֹגְיָה	farmakologya
פָּרָנוֹאִידִי	paranoidi
פָּרַס	paras
פָּרָס	paras
פֶּרֶס	peres
פְּרָס	pras
פַּרְסָה	parsa
פַּרְסִי	parsi
פַּרְסִית	parsit
פִּרְסֵם	pirsem
פֻּרְסַם	pursam
פִּרְסְמָה	pirsma
פֶּרְסְפֶּקְטִיבָה	perspektiva
פַּרְעֹה	paro
פַּרְעֹה	paro
פַּרְעוֹנֵי־	paronei-
פַּרְעוֹשׁ	parosh
פַּרְפַּר	parpar
פַּרְפָּרִים	parparim
פָּרַץ	parats
פֶּרֶץ	perets
פַּרְצוּף	partsuf
פַּרְצוּפִים	partsufim
פָּרַק	parak
פַּרְק	park
פֶּרֶק	perek
פְּרָקִים	prakim, praqim
פְּרַקְלִיט	praklit
פִּרְקָנִי	pirqani
פָּרָשׁ	parash
פָּרַשׁ	parash
פָּרָשָׁה	parasa
פְּרָת	prat
פָּשׁוּט	pashut
פִּשּׁוּט	pishut
פָּשַׁט	pashat
פִּשֵּׁט	pishet
פְּשַׁט	pshat
פֻּשַּׁט	pushat
פָּשַׁט אֶת הָרֶגֶל	pashat et haregel
פַּשְׁטוֹ	pashto
פְּשִׁיטַת־רֶגֶל	pshitat-regel
פֶּשַׁע	pesha
פֶּשַׁע מִלְחָמָה	pesha milkhama
פָּשַׁר	pashar
פֵּשֶׁר	pesher
פִּשֵּׁר	pisher
פִּשְׁתָּה	pishta
פַּת	pat
פֹּת	pot
פִּתְאוֹם	pitom
פִּתְאוֹמִי	pitomi
פִּתְגָּם	pitgam
פָּתוּחַ	patuakh
פִּתּוּחַ	pituakh
פָּתוֹלוֹג	patolog
פָּתוֹלוֹגְיָה	patologia
פַתְ״ח	fatkh
פַּתַח	patakh
פָּתַח	patakh
פֶּתַח	petakh
פִּתֵּחַ	piteakh
פֶּתַח תִּקְוָה	petakh tikva
פִּתְרוֹן	pitron
צֹאן	tson, son
צַב	tsav
צָבָא	tsava
צִבְאוֹת־	tsivot-
צְבָאוֹת	tsvaot
צְבָאִי	tsvai
צִבּוּר	tsibur
צִבּוּרִי	tsiburi
צְבִי	tsvi
צַבָּע	tsaba
צָבַע	tsava
צֶבַע	tseva
צְבָעִים	tsvaim
צַבָּר	tsabar
צָבַר	tsavar
צָד	tsad
צַד	tsad
צַדִּיק	tsadik
צָדַק	tzadak
צֶדֶק	tzedek
צְדָקָה	tsdaka
צְדָקִים	tsdakim
צַדֶּקֶת	tsadeket
צָהֹב	tsahov
צְהַבְהַב	tshavhav
צָהֳלָה	tsohola
צָהֳרָיִם	tsahorayim
צָהֳרַיִם	tsohorayim
צַו	tsav
צַוָּאָה	tzavaa
צַוָּאר	tsavar
צַוָּארוֹן	tsavaron
צוּד	tsud
צוֹדֵק	tsodek
צִוָּה	tsiva
צִוָּהוּ	tsivahu
צו הרחקה	tsav-harkhaka
צ׳וֹלְנְט	cholnt
צוֹם	tsom
צוּנַמי	tsunami
צוֹעֲנִי	tsoani
צ׳וּפְּצִ׳יק	chupchik
צוּק	tzuk
צוֹר	tsor
צוּר	tsur
צוּרָה	tsura
צֶוֶת	tsevet
צַח	tsakh
צְחוֹק	tskhok
צָחִיחַ	tsakhiakh
צָחַק	tsakhak
צִטּוּט	tsitut
צִטֵּט	tsitet
צֻטַּט	tsutat
צִי	tsi
צַיָּד	tsayad
צַיִד	tsayid
צִידוֹן	tsidon
צַיָּדֵי	tsayadei
צַיָּדִים	tsayadim
צַיֶּדֶת	tsayedet
צִיּוֹן	tsiyon
צִיּוּן	tsiyun
צִיּוֹנוּת	tsiyonut
צִיּוּנִים	tziyunim
צִיּוּר	tsiyur
צִיּוּרֵי־	tsiyurei-
צִיּוּרִי	tsiyuri
צִילֵּם	tsilem
צִימֵר	tsimer
צ־י־ן	ts-y-n
צֵ׳יְסֶר	cheyser
צִיפִּי	tsipi
צִ׳יפְּס	chips
צִיץ	tsits
צִיצִיּוֹת	tsitsiyot
צִיצִית	tsitsit
צִיצִת	tsitsit
־צִ׳יק	-chik
צִ׳יק צָ׳ק	chik-chak
צַיָּר	tsayar
צִיֵּר	tsiyer
צֵירֵי	tseire
צִירִיךְ	tzirikh
צֵל	tsel
צָלַב	tzalav
צְלָב	tzlav
צְלַב קֶרֶס	tslav keres
צָלוּל	tsalul
צִלּוּם	tzilum
צלחות	tzalakhot
צַלַּחַת	tsalachat
צְלִיל	tslil
צַלָּם	tsalam
צֶלֶם	tselem
צֶלַע	tsela
צָלַע	tsolea
צְלָפְחָד‎	tslofchad
צִלְצֵל	tsiltsel
צָם	tsam
צַמָּה	tsama
צָמַח	tsamakh
צֶמַח	tsemakh
צמיגים	tzmigim
צִמְצֵם	tsimtsem
צֶמֶר	tsemer
צֹמֶת	tsomet
צְנוֹן	tsnon
צָנוּעַ	tsanua
צִנּוֹר	tsinor
צְנִיעוּת	tsniut
צִנְצֶנֶת	tsintsenet
צָעִיר	tzair
צְעִירָה	tsira
צָעַן	tsaan
צַעֲצוּעַ	tsaatsua
צַעֲקַת	tsaakat
צַעֲקָתָם	tsaakatam
צַעַר	tsaar
צָפָה	tsafa
צִפָּה	tsipa
צָפוּי	tsafui
צָפוּן	tsafun
צָפוֹן	tzafon
צִפּוֹר	tsipor
צִפּוֹרָה	tsipora
צֶפַע	tsefa
צְפַרְדֵּעַ	tzfardea
צִפֹּרָה	tzipora
צִפֹּרֶן	tsiporen
צְפַת	tsfat
צֶ׳ק	chek
צַר	tsar
צֹר	tsor
צַר אֹפֶק	tsar ofek
צָרָה	tsara
צרוף לשון	tzeiruf lashon
צָרוּר	tsarur
צְרוֹר	tsror
צָרוֹת	tsarot
צָרוּת	tsarut
צָרַח	tsarakh
צְרִיחַ	tsriyakh
צָרִיךְ	tsarikh
צְרִיכָה	tsrikha
צָרִים	tsarim
צָרַךְ	tsarakh
צֹרֶךְ	tsorekh
צַרְכָן	tzarchan
צִרְעָה	tzirah
צַר עַיִן	tsar ayin
צָרַעַת	tsaraat
צֵרֵף	tseref
צָרְפַת	tsarfat
צָרְפָתִי	tsarfati
צָרְפָתִית	tsarfatit
צַרְצוּר	tzartzur
צִרְצוּר	tzirtzur
צְרָצַר	tsratsar
צַתְרָה	tsatra
קֵבָה	keva
קִבּוּץ	kibutz
קֻבּוּץ	kubuts
קְבוּצָה	kvutza
קְבוּצוֹת	kvutzot
קִבּוּצִי	kibutsi
קְבוּצַת־	kvutzat
קְבוּצַת חָזְקָה	kvutzat khozka
קְבוּרָה	kvura
קִבֵּל	kibel
קַבָּלָה	kabala
קַבָּלוֹת	kabalot
קַבְּצָן	kabtzan
קָבַר	kavar
קֶבֶר	kever
קִבֹּרֶת	qiboret
קָדוּם	kadum
קָדוֹשׁ	kadosh
קִדּוּשׁ	kidush
קִדּוּשׁ	kidush
קַדַּחַת	kadakhat
קָדִימָה	kadima
קַדִּישׁ	kadish
קָדַם	kadam
קְדַם־	kdam-
קֶדֶם	kedem
קִדֵּם	kidem
קֹדֶם	kodem
קִדְמִי	kidmi
קָדְקֹד	kodkod
קָדֵשׁ	kadesh
קִדֵּשׁ	kidesh
קֹדֶשׁ	kodesh
קֻדַּשׁ	kudash
קֻדַּשׁ	kudesh
קְדֻשָּׁה	kdusha
קַדְּשֵׁנוּ	kadshenu
קִדַּשְׁנוּ	kidashnu
קִדְּשָׁנוּ	kidshanu
קַהְוָה, קַהֲוָה	kahva, kahava
קָהִיר	kahir
קָהָל	qahal
קְהִלָּה	khila
קֹהֶלֶת	kohelet
קַו	kav
קוֹאוֹפֵּרָטִיב	kooperativ
קוֹאָלִיצְיָה	koalitsya
קוּגֶל	kugel
קוֹדֵחַ	qodeakh
קִוָּה	kiva
קְווִידִיץ׳	kwidich
קוֹטֶג׳	kotej
קוֹל	kol
קוּל	kul
קוֹלוֹת	kolot
קוֹלְחוֹז	kolkhoz
קוֹלָן	kolan
קוֹלְנוֹעַ	kolnoa
קוֹלָנִי	kolani
קוֹל צָף	kol tsaf
קוֹל קוֹרֵא	kol kore
קוּם	kum
קוֹמְבִּינָה	kombina
קוֹמָה	koma
קוּמוּלוּס	kumulus
קוּמְזִיץ	kumzits
קוֹנְדּוֹם	kondom
קוֹנְדּוֹמִים	kondomim
קוֹנְדִיטוֹר	konditor
קְוַנְט	kvant
קוֹנְסְפִּירָצְיָה	konspiratsya
קוֹנְסֶרְבָטִיבִי	konservativi
קוֹנְסֶרְבָטִיבִית	konservatit
קוֹסֵם	kosem
קוֹסְמוֹלוֹגְיָה	kosmologia
קוֹף	kof
קוּ״ף	kuf
קוּף	kuf
קוּפִּידוֹן	kupidon
קוֹפִים	kofim
קוֹץ	qotz
קוֹצֵר	kotser
קוּקוּ	kuku
קוּקִית	kokit
קוּר	kur
קו רוחב	kav rokhav
קוֹרֵיאָה	korea
קוּרְס	kurs
קִזּוּז	kizuz
קָט	kat
קִטֵּב	kitev
קֹטֶב	kotev
קָטְבִּי	kotbi
קָטֵגוֹרְיָה	kategorya
קָטִיל	katil, qatil
קְטִילָה	ktila
קָטַל	katal
קֶטֶל	ketel
קִטֵּל	kitel
קֹטֶל	kotel, qotel
קִטְלֵג	kitleg
קֻטְלַג	kutlag
קְטֵלָה	ktela, qtela
קְטֻלָּה	ktula, qtulla
קִטָּלוֹן	kitalon, qittalon
קִטְלוֹן	kitlon, qitlon
קְטַלְטַל	ktaltal, qtaltal
קַטְלָנִי	katlani
קָטָן	katan
קָטֹן	katon
קְטַנְטַן	ktantan
קָטַנְצִ׳יק	katanchik
קָטַף	kataf
קֹטֶר	koter
קָטָר	qatar
קִטֵּר	qiter
קֹטֶר	qoter
קִיֶב	kiyev
קִיבּוּץ	kibutz
קִיבּוּצְנִיק	kibutznik
קִיּוּם	kiyum
קַיְטָנָה	kaitana
קִילוֹמֶטֶר	kilometer
קַיָּם	kayam
קִיֵּם	kiyem
קִיֵּם יַחֲסֵי מִין	kiyem yakhasei min
קַיִן	kayin
קַיִץ	kayits
קֵיצִים	kayitsim
קִיר	kir
קֵל	kel
קַל	qal
קֹל	qol
קַל דַּעַת	kal daat
קַלָּה	kala
קָלָה	qala
קַלּוּ	kalu
קֹלוֹ	kolo
קַלּוֹת	qalot
קַלּוּת	qalut
קָלַח	kalakh
קָלַט	kalat
קָלִיגְרָפְיָה	kaligrafya
קְלִיד	klid
קְלִיפּ	klip
קְלִיפָה	klifa
קְלִיק	klik
קֹלְךָ	kolcha
קְלָלָה	klala
קֻלְמוּס	kulmus
קַלְמָר	kalmar
קַלְמָרִין	kalmarin
קָלַף	kalaf
קְלָף	klaf
קְלִפָּה	klipa
קִלְקֵל	kilkel
קָם	kam
קֶמַח	kemakh
קָמָץ	kamats
קֵן	ken
קַנָּא	kana, qanna
קִנֵּא	kine
קִנֵּא	kine
קִנְאָה	kina
קַנָּאוּת	kanaut
קְנָאוֹת	knaot
קַנָאִי	kanai
קָנָדָּה	kanada
קָנָה	kana
קָנֶה	kane
קִנּוּחַ	kinuach
קִנֵּחַ	kineach
קִנְטֵר	qinter
קֻנְטַר	quntar
קֶנְיָה	kenya
קְנִיָּה	kniya
קַנְיוֹן	kanyon
קִנִּים	kinim
קְנִישׁ	knish
קִנָּמוֹן	kinamon
קִנָּמוֹן	kinamon
קָסָאם	kasam
קַסְדָּה	kasda
קָסוּם	kasum
קְסִילוֹפוֹן	ksilofon
קֶסֶם	kesem
קֶסֶת	keset
קַעֲקַע	kaaka
קִעְקֵעַ	lt--israeli native says kiakea, niqqud say niekea--gt
קְעָרָה	qearah
קַעֲרִית	qaarit
קָפָא	kafa
קָפָּא	kappa
קִפָּאוֹן	kipaon
קָפֶה	kafe
קָפֶה הָפוּךְ	kafe hafukh
קָפֶה נָמֵס	kafe names
קָפֶה קָפוּא	kafeh kafu
קַפוּצִ׳ינוֹ	kapuchino
קִפֵּל	kipel
קֻפְסָה	qufsa
קָפַץ	kafats
קַפְרִיסָאִי	kafrisai
קַפְרִיסִין	qafrisin
קֵץ	kets
קָצוּץ	katsuts
קִצּוּץ	qitsuts
קִצּוּר	kitsur
קִצּוּר־דֶּרֶךְ	kitsur-derekh
קְצִיצָה	ktsitsa
קְצִיצוֹת	ktsitsot
קֶצֶף	ketsef
קְצֶפֶת	ktzefet
קָצָר	katsar
קִצֵּר	kitser
קֹצֶר	kotser
קֻצַּר	kutsar
קְצַרְצַר	ktsartsar
קְצָת	ktsat
קָקָאוֹ	kakao
קק״ל	kkl
קַר	kar
קֹר	kor
קָרָא	kara
קָרָא	qara
קָרָאִי	karai
קִרְאֶן	kiren
קֻרְאָן	kuran  koran
קָרַב	karav
קְרָב	krav
קְרַב אִגְרוּף	krav igruf
קָרְבָּן	korban
קָרְבָּנוֹת	korbanot
קְרַב רַב	krav rav
קָרָה	qara
קָרוּא	karu
קָרוֹב	karov
קְרוֹבָה	krova
קְרוֹבוֹת	krovot
קָרָוָן	qaravan
קֶרַח	kerakh
קֵרֵחַ	kereakh
קֹרַח	korakh
קַרְחוֹן	karkhon
קַרְחִי	karkhi
קָרִיא	kari
קִרְיָה	kirya
קְרִיזָה	kriza
קֶרִי לַיְלָה	keri layla
קְרִיקֶט	kriket
קָרִיקָטוּרָה	karikatura
קִרְיַת גַּת‎	kiryat gat
קִרְיַת שְׁמוֹנָה‎	kiryat shmona
קֹר כְּלָבִים	kor klavim
קָרַן	karan
קֶרֶן	keren
קֶרֶן	keren
קָרַע	qara
קַרְפָּד	karpad
קַרְפָּדָה	karpada
קַרְקַע	karka
קַשׁ	kash
קַשָּׁב	kashav
קֶשֶׁב	keshev
קָשֶׁה	kashe
קָשׁוּר	kashur
קִשּׁוּר	kishur
קִשּׁוּרִים	kishurim
קֹשִׁי	koshi
קָשִׁיחַ	kashiakh
קְשִׂיטָה	ksita
קָשִׁישׁ	kashish
קְשִׁישָׁה	kshisha
קַשָּׁר	kashar
קָשַׁר	kashar
קֶשֶׁר	kesher
קִשֵּׁר	kisher
קַשָּׁת	kashat
קֶשֶׁת	keshet
קְשָׁתוֹת	kshatot
קָתֶדְרָלָה	katedrala
רָאָה	raa
רֵאָה	rea
רֹאֶה	roe
רְאוּבֵן	ruven
רָאוּי	raui
רֵאוֹת	reat
רֵאוֹת	reot
רֵאוֹת	reot
רְאוֹת	rot
רְאוּת	rut
רְאָיָה	reaya
רְאִיָּה	reiya
רֵאָיוֹן	reayon
רָאִינוּ	rainu
רָאִיתִי	raiti
רְאִיתֶן	riten
רְאֵם	rem
רֹאשׁ	rosh
רֹאשׁ־הַמֶּמְשָׁלָה	rosh-hamemshala
רֹאשׁ הַשָּׁנָה	rosh-hashana
רִאשׁוֹן	rishon
רִאשׁוֹן לְצִיּוֹן	rishon ltsiyon
רִאשׁוֹנָה	rishona
רָאשֵׁי	rashei
רָאשִׁי	rashi
רָאשִׁים	rashim
רָאשֵׁי תֵבוֹת	rashei teivet
רֹאשׁ־מֶמְשָׁלָה	rosh-memshala
רֹאשָׁן	roshan
רֹאשָׁנִים	roshanim
ראש עירייה	rosh iria
רֵאַת	reat
רַב	rav
רָב	rav
רְבָבָה	rvava
רָבָה	rava
רִבּוֹן	ribon
רִבּוֹנֵי	ribonei
רִבּוֹנִי	riboni
רִבּוּעַ	ribua
רַבּוֹת	rabot
רַבִּי	rabi
רְבִיעִי	rvii
רִבִּית	ribit
רַב־מַלְאָךְ	rav-malakh
רַבֵּנוּ	rabeinu
רַבָּנִים	rabanim
רֹבַע	rova
רֹבַע	rova
רִבְעוֹן	rivon
רִבְקָה	rivka
רַבְשָׁקֵה	ravshake
רָגוּעַ	ragua
רָגִיל	ragil
רֶגֶל	regel
רַגְלָיו	raglav
רַגְלַיִךְ	raglayich
רגליך	raglcha
רַגְלֶיךָ	raglecha
רֶגַע	rega
רֹגַע	roga
רְגָעִים	rgaim
רֶגֶשׁ	regesh
רְגָשׁוֹת	rgashot
רִגְשִׁי	rigshi
רַדְיוֹ	radyo
רַהַב	rahav
רָהוּט	rahut
רִהוּט	rihut
רִהֵט	rihet
רֹהַט	rohat
רָהִיט	rahit
רְהִיטוּת	rhitut
רוֹאֶה	roe
רוֹאֵה חֶשְׁבּוֹן	roe kheshbon
רוֹבֶה	rove
רוּגַאֲטְקָה	rugatqa
רוּגַטְקָה	rugatqa
רוֹגֵעַ	rogea
רוּחַ	ruach
רוּחַ הַזְּמַן	ruach hazman
רוּחַ הַקֹּדֶשׁ	ruah haqqodes
רוּחָנִי	rukhani
רוּחָנִיּוֹת	rukhaniyot
רוּחָנִיּוּת	rukhaniyut
רוטב סויה	rotev-soya
רְוָיָה	revaya
רוֹם	rom
רוּם	rum
רוֹמָא	roma
רוֹמַם	romam
רוֹמֵם	romem
רוֹמָן	roman
רוֹמַנְיָה	romanya
רוֹמָנִית	romanit
רוֹן	ron
רוּסִי	rusi
רוּסְיָה	rusya
רוּסִית	rusit
רוֹפֵא	rofe
רוֹפְאָה	rofa
רוֹצָה	rotsa
רוֹצֶה	rotse
רוֹצִים	rotsim
רַוָּק	ravak
רַוָּק	ravaq
רוֹק	roq
רוֹקַח	rokakh
רוֹקֵחַ	rokeakh
רוֹקַחַת	rokakhat
רוּת	rut
רוֹתֵחַ	roteakh
רָזָה	raza
רָזֶה	raze
רָחָב	rachav
רְחָבָה	rchava
רְחַב יָדַיִם	rakhav yadayim
רְחוֹב	rekhov
רְחוֹבוֹת	rkhovot
רְחוֹבוֹת	rkhovot
רָחוֹק	rakhok
רָחוֹק	rakhok
רֵחַיִם	rekhayim
רָחֵל	rachel
רָחַם	rakham
רֶחֶם	rekhem  rakham
רִחֵם	rikhem
רֻחֵם	rukham
רַחֲמִים	rakhamim
רַחְמָנוּת	rakhmanut
רִחֵף	rikhef
רָחַץ	rachats
רָטֹב	ratov
רֹטֶב	rotev
רָטוּב	ratuv
רְטוּבָה	rtuva
רֶטְרוֹאַקְטִיבִי	retroactivi
רֵיחַ	reakh
רֵיחָן	rehan
רִיס	ris
רִיסִים	risim
רֵיק	reik
רֵיקָם	rekam
רַךְ	rakh
רֹךְ	rokh
רָכַב	rakhav
רֶכֶב	rechev
ר־כ־ב	r-k-b
רַכֶּבֶל	rakevel
רַכֶּבֶת	rakevet
רִכּוּז	rikuz
רְכִילוּת	rechiylut
רָם	ram
רַמָּאוּת	ramaut
רַמְבַּ״ם	rambam
רַמְבַּ״ן	ramban
רָמָה	rama
רִמָּה	rima
רִמּוֹן	rimon
רִמּוֹנָדָה	rimonada
רִמּוֹנִים	rimonim
רָמַז	ramaz
רֶמֶז	remez
רַמְזוֹר	ramzor
רַמְלָה	ramla
רֶמֶץ	remets
רָמַשׂ	ramas
רֶמֶשׂ	remes
רָמַת גַּן	ramat gan
רַן	ran
רֹן	ron
רִנָּה	rina
רִנָּה	rina
רִסֵּס	rises
רַע	ra
רֵעַ	rea
רָעַב	raav
רָעָב	raav
רָעֵב	raev
רָעַד	raad
רָעָה	raa
רֵעָה	rea
רְעוּאֵל	ruel
רֹעִי	roi
רַעֲיוֹן	raayon
רֵעֲךָ	reacha
רַעַל	raal
רַעַם	raam
רַעְמְסֵס	ramses
רַעֲנַנָּה	raanana
רַעַשׁ	raash
רָעַשׁ	raash
רַעֲשָׂן	raashan
רַעֲשָׁנִי	raashani
רָפָא	rafa
רִפֵּא	ripe
רֻפָּא	rupa
רִפֵּד	riped
רֻפַּד	rupad
רָפֶה	rafe
רְפוּאָה	rfua
רְפוּאוֹת	rfuot
רְפוּאִי	rfui
רְפוּאַת	rfuat
רֶפּוּבְּלִיקָה	republika
רִפּוּד	ripud
רַפְסוֹדָה	rafsoda
רֶפֶת	refet
רָץ	ratz
רִצֵּד	ritsed
רָצָה	ratsa
רִצָּה	ritsa
רָצוּי	ratzui
רָצוֹן	ratzon
רָצוֹן טוֹב	ratzon tov
רְצוּעָה	rtsua
רָצַח	ratzakh
רֶצַח	retzakh
רְצִינִי	rtsini
רִצְפָּה	ritspa
רַק	rak
רֹק	roq
רָקַד	rakad
רַקְדָן	rakdan
רַקְדָנִית	rakdanit
רָקוּב	rakuv
רִקּוּד	riqud
רָקֶטָה	raketa
רֶקְטוּם	rektum
רָקִיעַ	rakia
רְקִיעִים	rkiim
רָקַע	raka
רֶקַע	reka
רִקַּע	rika
רֻקַּע	ruka
רִשּׁוּת	rishut
רַשִׁ״י	rashi
רְשִׁימָה	rshima
רְשִׁימוֹת	reshimot
רְשִׁימָת	reshimat
רָשַׁם	rasham
ר־שׁ־ם	r-sh-m
רִשְׁמִי	rishmi
רָשָׁע	rasha
רֶשָׁע	resha
רִשְׁעוּת	rishut
רְשָׁעִים	rshaim
רֶשֶׁף	resheph
רֶשֶׁת	reshet
רִשֵּׁת	rishet
רַתָּךְ	ratakh
רִתֵּךְ	ritekh
רֻתַּךְ	rutakh
שֶׁ־	she-
שָׁאוּל	shaul
שְׁאוֹל	shol
שְׁאִיבַת־שֻׁמָּן	shivat-shuman
שָׁאַל	shaal
שְׁאֵלָה	shela
שַׁאנְג-חָאי	shang-khai
שָׁאַף	shaaf
שְׁאָר	shar
שָׁב	shav
שֵׁב	shev
שְׁבָבִים	shvavim
שָׁבָה	shava
שְׁבָה	shva
שָׁבוּי	shavuy
שָׁבוּעַ	shavua
שְׁבוּעָה	shvua
שָׁבוּעוֹת	shavuot
שְׁבוּעוֹת	shvuot
שְׁבוּעַיִם	shvuayim
שָׁבוּר	shavur
שֶׁבַח	shevakh
שִׁבֵּחַ	shibeakh
שֻׁבַּח	shubakh
שֵבֶט	shevet
שְׁבָט	shvat
שִׁבְטִי	shivti
שָׁבִיט	shavit
שְׁבִיל	shvil
שְׁבִיל הֶחָלָב	shvil hekhalav
שְׁבִיעִי	shvii
שֹׁבֶל	shovel
שַׁבְּלוּל	shablul
שִׁבֹּלֶת	shibolet
שִׁבֹּלֶת	shibolet, sibbolet
שִׁבֹּלֶת שׁוּעָל	shibbolet shual
שָׂבַע	sava
שֶׁבַע	sheva
שֹׂבַע	sova
שִׁבְעָה	shiva
שִׁבְעִים	shivim
שִׁבְעָתַיִם	shivatyim
שָׁבָץ	shavats
שָׁבַר	shavar
שֶׁבֶר	shever
שִׁבֵּר	shiber
שֻׁבַּר	shubar
שִׂבֵּר	siber
שְׁבָרִים	shvarim
שַׁבָּת	shabat
שָׁבַת	shavat
שֶׁבֶת	shevet
שַׁבְּתַאי	shabtai
שַׁבָּתוֹן	shabaton
שַׁבָּתוֹת	shabatot
שַׁבָּת שָׁלוֹם	shabat shalom
שְׁגִיאָה	shgia
שְׁגִיאַת כְּתִיב	shgiat ktiv
שִׁגֵּעַ	shigea
שִׁגָּעוֹן	shigaon
שִׁגֵּר	shiger
שִׁגְרָה	shigra
שַׁגְרִיר	shagrir
שַׁגְרִירוּת	shagrirut
שַׁגְרִירִים	shagririm
שָׁד	shad
שֵׁד	shed
שֹׁד	shod
שֹד	shod
שָׂדֶה	sade
שִׁדּוּר	shidur
שִׁדּוּר חוֹזֵר	shidur-khozer
שִׁדּוּרִים	shidurim
שָׁדַיִם	shadayim
שַׁדָּר	shadar
שֶׁדֶר	sheder
שִׁדְרוּג	shidrug
שְׂדֵרוֹת‎‎	sderot
שַׁדְרָן	shadran
שֶׂה	se, se
שֹׁהַם	shoham
שָׁוְא	shav
שְׁוָא	shva
שׁוֹאָה	soa
שׁוֹאוֹת	shoot
שׁוֹאַת	shoat
שׁוּב	shuv
שׁוֹדֵד	shoded
שׁוֹדֵד יָם	shodet yam
שְׁוֶדְיָה	shvedya
שָׁוֶה	shave
שִׁוּוּק	shivuk
שׂוֹחֵחַ	sokheakh
שׁוֹחֵט	shokhet
שׁוֹט	shot
שׁוֹטֶה	shote
שׁוֹטֵט	shotet
שׁוֹטֵר	shoter
שׁוֹטְרוֹת	shotrot
שׁוֹטֶרֶת	shoteret
שׁוּל	shul
שׁוּם	shum
שׂוּם	sum
שׁוֹמֵר	shomer
שׁוּמֶר	shumer
שׁוֹמְרִים	shomrim
שׁוֹמֵר שַׁבָּת	shomer shabat
שׂוֹנֵא	sone
שׁוֹנֶה	shone
שׁוּעָל	shual
שׁוּף	shuf
שׁוֹפֵט	shofet
שׁוֹפְטֵי	shoftei
שׁוֹפְטִים	shoftim
שׁוֹפְכָן	shofkhan
שׁוֹפָר	shofar
שִׁוֵּק	shivek
שׁוֹק	shok
שׁוּק	shuk
שׁוֹקוֹלָד	shokolad
שׁוֹר	shor
שׁוּרָה	shura
שׁוּרוּק	shuruk
שׁוּרוֹת	shurot
שׁוֹרַשׁ	shorash
שׁוֹרֵשׁ	shoresh
שׁוּרַת	shurat
שׁוֹשָׁן	shoshan
שׁוּשָׁן	shushan
שׁוֹשַׁנָּה	shoshana
שׁוֹשַׁנָּה	shoshana
שָׁזַף עַיִן בְּ־	shazaf ayin
שֹׁחַד	shokhad
שָׂחָה	sakha
שָׁחוּם	shachum
שְׁחוֹר	shkhor
שִׁחְזוּר	shikhzur
שְׁחִיטָה	shkhita
שְׁחִיתוּת	shkhitut
שְׁחַמְחַם	shkhamkham
שַׁחְמָט	shakhmat
שַׁחֶפֶת	shakhefet
שְׁחָקִים	shkhakim
שַׂחְקָן	sakhqan
שַׂחְקָנִים	sakhkanim
שַׂחְקָנִית	sakhkanit
שַׁחַר	shakhar
שָׁחֹר	shakhor
שַׁחֲרוּר	shakharur
שִׁחְרוּר	shikhrur
שִׁחְרוּרוֹ	shikhruro
שִׁחְרוּרִים	shikhrurim
שְׁחַרְחַר	shkharkhar
שְׁחַרְחֶרֶת	shkharkhoret
שִׁחְרֵר	shikhrer
שֻׁחְרַר	shukhrar
שָׁט	shat
שָׁטַח	shatakh
שֶׁטַח	shetakh
שִׁטֵּחַ	shiteakh
שָׁטִיחַ	shatiakh
שָׁטִיחַ אָדֹם	shatiakh adom
שָׂטָן	satan
שָׁטַף	shataf
שֶׁטֶף	shetef
שַׁי	shay
שִׂיחַ	siakh
שִׂיחָה	sikha
שִׁיטָה	shita
שַׁיָּךְ	shayakh
שִׁימּוּשׁ	shimush
שִׁימּוּשִׁים	shimushim
שִינְקֶה	shinke
שִינְקֶן	shinken
שִׁיעִי	shii
שִׁיפוֹן	shifon
שִׁיר	shir
שַׁיָּרָה	shayara
שִׁירָה	shira
שִׁירָה	shira
שִׁירוֹת	shirot
שִׁירִים	shirim
שִׁית	shit
שָׁכַב	shakhav
שְׁכוּנָה	shkhuna
שָׁכַח	shakhakh
שַׁכְחָן	shakhekhan
שַׂכִּין	sakin
שְׁכִינָה	shkhina
שֵׂכֶל	sekhel
שִׁכְלוּל	shikhlul
שָׁכַן	shakhan
שָׁכֵן	shakhen
שִׁכְנֵעַ	shichnea
שִׁכְנֵעַ	shikhnea
שׁ־כ־נ־ע	sh-k-n-
שֻׁכְנַע	shukhna
שְׁכֶנְתָּהּ	shchentah
שָׂכַר	sakhar
שָׂכָר	sakhar
שֶׂכֶר	sekher
שָׁכַר	shakhar
שֵׁכָר	shekhar
שִׁכֵּר	shiker
שִׁכְתֵּב	shikhtev
שַׁל	shal
שֶׁלְּ־	shel-
שֶׁל	shel
שְׁלָבִּים	shlabim
שָׁלָב, שְׁלָב	shalav, shlav
שֶׁלֶג	sheleg
שִׁלְגִּיָּה	shilgiya
שְׁלָגִים	shlagim
שֶׁלֶד	sheled
שֶׁלָּהּ	shelah
שִׁלֹה	shilo
שָׁלֵו	shalev
שֶׁלּוֹ	shelo
שְׂלָו	slav
שַׁלְוָה	shalva
שָׁלוֹם	shalom
שָׁלוֹם עֲלֵיכֶם	shalom aleikhem
שָׁלוֹשׁ	shalosh
שְׁלוֹשָׁה	shlosha
שְלוֹשָׁה עָשָׂר	shlosha asar
שְׁלוֹשִׁים	shloshim
שְׁלוֹשׁ עֶשְׂרֵה	shlosh esre
שָׁלַח	shalach
שֶׁלַח	shelach
שִׁלֵּחַ	shileach
שִׁלְחוֹ	shilcho
שֻׁלְחָן	shulchan
שֻׁלְחָן	shulkhan
שֻׁלְחָנוֹת	shulchanot
שַׁלְּחֵנִי	shalcheni
שְׁלָחַנִי	shlachani
שֻׁלְחָנִי	shulchani
שְׁלַחְתִּיךָ	shlachticha
שַׁלָּט	shalat
שָׁלַּט	shalat
שֶׁלֶט	shelet
שִׁלְטוֹן	shilton
שִׁלְטוֹן	shilton
שַׁלָּט רָחוֹק	shalat rakhok
שֶׁלִּי	sheli
שָׁלִיחַ	shaliakh
שְׁלִיחָה	shlikha
שְׁלִיטָה	shlita
שְׁלִילִי	shlili
שָׁלִישׁ	shalish
שְׁלִישׁ	shlish
שְׁלִישִׁי	shlishi
שֶׁלָּךְ	shelakh
שֶׁלְךָ	shelkha
שָׁלַם	shalam
שָׁלֵם	shalem
שָׁלֵם	shalem
שִׁלֵּם	shilem
שַׂלְמָה	salma
שִׁלְּמָה	shilma
שְׁלֵמָה	shlema
שְׁלֹמֹה	shlomo
שְׁלֵמוּת	shlemut
שֶׁלָּנוּ	shelanu
שַׁלְפּוּחִית	shalpukhit
שָׁלֹשׁ	shalosh
שְׁלֹשָׁה	shlosha
שִׁלְשׁוֹם	shilshom
שְׁלֹשֶׁת	shloshet
שָׂם	sam
שָׁם	sham
שָׁם	sham
שֵׁם	shem
שָׂם לֵב	sam lev
שֵׁם לְוַאי	shem levai
שֵׁם מִשְׁפָּחָה	shem mishpakha
שם משתמש	shem mishtamesh
שֵׁם עֶצֶם	shem etsem
שֵׁם פְּעֻלּה	shem-peula
שם פרטי	shem prati
שְׂמֹאל	smol
שְׂמָאלִי	smali
שָׂמוֹ	samo
שָׂמוּ	samu
שָׁמוּ	shamu
שְׁמוֹ	shmo
שְׁמוּאֵל	shmuel
שִׁמּוּן	shimun
שְׁמוֹנָה	shmona
שְׁמוֹנֶה	shmone
שְׁמוֹנִים	shmonim
שְׁמוּעָה	shmua
שִׁמּוּר	shimur
שֵׁמוֹת	shemot
שְׁמוֹת	shmot
שָׂמַח	samakh
שָׂמֵחַ	sameakh
שִׂמֵּחַ	simeakh
שִׂמְחָה	simkha
שִׂמְחָתֵנוּ	simchatenu
שְׁמִי	shmi
שְׁמִיטָה	shmita
שְׂמִיכָה	smikha
שָׁמַיִם	shamayim
שְׁמֵימִי	shmeymiy
שְׁמִינִי	shmini
שְׁמִינִי עֲצֶרֶת	shmini atseret
שְׁמִירָה	shmira
שמירטוף	shmirtuf
שְׁמִירַת	shmira
שָׂמְךָ	samcha
שִׁמְךָ	shimcha
שְׁמֵךְ	shmech
שִׂמְלָה	simla
שִׂמְלַת	simlat
שְׂמָלֹת	smalot
שָׁמַן	shaman
שָׁמֵן	shamen
שֶׁמֶן	shemen
שִׁמֵּן	shimen
שֻׁמָּן	shuman
שְׁמָנִים	shmeinim
שְׁמַנְמַן	shmanman
שַׁמֶּנֶת	shamenet
שָׁמַע	shama
שֵׁמַע	shema
שְׁמַע	shma
שִׁמְעוֹן	shimon
שִׁמְעִי	shimi
שְׁמַעְיָה	shmaya
שָׁמַעְתִּי	shamati
שַׁמְפַּנְיָה	shampania
שָׁמַר	shamar
שֶׁמֶר	shemer
שִׁמֵּר	shimer
שֻׁמַּר	shumar
שֻׁמָּר	shumar
שְׁמַרְטַף	shmartaf
שְׁמִרְטֵף	shmirtef
שְׁמֻרְטַף	shmurtaf
שִׁמְרִית	shimrit
שָׁמַרְנוּ	shamarnu
שָׁמַרְתְּ	shamart
שָׁמַרְתָּ	shamarta
שָׁמַרְתִּי	shamarti
שַׁמָּשׁ	shamash
שֶׁמֶשׁ	shemesh
שִׁמֵּשׁ	shimesh
שִׁמְשׁוֹן	shimshon
שְׁמָשׁוֹת	shmashot
שִׁמְשִׁי	shimshi
שֻׁמְשֹׁם	sumsm
שֵׁן	shen
שֵׁן בִּינָה	shen bina
שָׂנֵא	sane
שִׂנְאָה	sina
שַׁנַּאי	shanai
שֹׂנְאֵינוּ	sonenu
שָׁנָה	shana
שֵׁנָה	sheina
שִׁנָּה	shina
שֻׁנָּה	shuna
שָׁנָה טוֹבָה	shana tova
שָׂנוּא	sanu
שִׁנּוּי	shinui
שְׁנוֹרְקֶל	shnorkel
שְׁנוֹרְקֶלִים	shnorkelim
שְׁנוֹת־	shnot-
שָׁנִי	shani
שָׁנִי	shani
שֵׁנִי	sheni
שִׁנִּי	shini
שֹׁנִי	shoni
שְׁנִיָּה	shniya
שְׁנִיּוֹת	shniyot
שָׁנִים	shanim
שְׁנַיִם	shnayim
שְׁנֵים עָשָׂר	shneyim asar
שְׁנִיצֶל	shnitsel
שֵׁנִית	shenit
שִׁנְמוּךְ	shinmukh
שִׁנְעָר	shinar
שְׁנֵקֶל	shnekel
שְׁנַת־	shnat-
שָׁעָה	shaa
שָׁעוֹן	shaon
שָׁעוּן	shaun
שָׁעוֹן מְעוֹרֵר	shaon morer
שִׁעוּר	shiur
שְׂעוֹרָה	seorah
שָׂעִיר	sair
שֵׂעִיר	seir
שִׁעְמוּם	shiamum
שֵׂעָר	sear
שַׁעַר	shaar
שִׁעֵר	shier
שַׂעֲרָה	saara
שערות סבתא	searot savta
שֶׁף	shef
שָׂפָה	safa
שִׁפּוּר	shipur
שָׂפוֹת	safot
שְׁפִיכָה	shfikha
שָׁפַךְ	shafakh
שָׁפַךְ אוֹר	shafakh or
שָׁפְכָה	shofkha
שָׂפָם	safam
שָׁפַע	shafa
שֶׁפַע	shefa
שַׁפַּעַת	shapaat
שִׁפֵּר	shiper
שְׂפַת־	sfat-
שְׂפָתַיִם	sfatayim
שְׂפָתַיִם גְּדוֹלוֹת	sfatayim gdolot
שְּׂפָתַיִם קְטַנּוֹת	sfatayim ktanot
שְׂפַת תִּכְנוּת	sfat tikhnut
ש״ץ	shats
שַׂק	sak
שָׁקַד	shakad
שָׁקֵד	shaked
שָׁקוּל	shakul
שָׁקוּף	shakuf
שָׁקַט	shakat
שָׁקֵט	shaket
שֶׁקֶט	sheket
שַׂקִּים	sakim
שְׁקִיעָה	shkia
שַׂקִּית	sakit
שָׁקַל	shakal
שֶׁקֶל	shekel
שֶׁקֶל חָדָשׁ	shekel khadash
שְׁקָלִים	shkalim
שִׁקְמָה	shikma
שִׁקְמִים	shikmim
שֶׁקֶר	sheker
שִׁקֵּר	shiker
שִׁקְרֵי	shikrei
שְׁקָרִים	shkarim
שַׁקְרָן	shakran
שַׁקְרָנִים	shakranim
שַׂק שֵׁנָה	sak-sheina
שַׂר	sar
שָׁר	shar
שָׁרָב	sharav
שְׁרָבִי	shravi
שָׂרָה	sara
שָׁרָה	shara
שֵׁרוּת	sheirut
שֵׁרוּתִים	sherutim
שָׂרַי	saray
שָׂרֵי	sare
שִׁרְיוֹן	shiryon
שִׂרְיוֹן	siryon
שָׂרִים	sarim
שָׁרִים	sharim
שְׁרִיקָה	shrika
שְׁרִיקוֹת	shrikot
שְׁרִיקַת	shrikat
שְׁרִיר	shrir
שְׁרִירֵי־	shrirei-
שְׁרִירִי	shriri
שָׂרִית	sarit
שָׂרַף	saraf
שָׂרָף	saraf
שְׂרָף	sraf
שְׂרֵפָה	srefa
שְׂרָפִים	srafim
שָׁרַץ	sharats
שֶׁרֶץ	sherets
שָׁרַק	sharak
שֹׁרַשׁ	shorash
שֹׁרֶשׁ	shoresh
שׁ־ר־שׁ	sh-r-sh
שָׁרְשִׁי	shorshi
שָׁרְשִׁיּוּת	shorshiyut
שֳׁרָשִׁים	shorashim
שַׁרְשֶׁרֶת	sharsheret
שָׁרָת	sharat
שֵׁרֵת	sheret
שָׂשׂ	sas
שֵׁשׁ	shesh
שֵׁשׁ בֵּשׁ	shesh besh
שִׁשָּׁה	shisha
שִׁשָּׁה עָשָׂר	shisha asar
שָׂשׂוֹן	sason
שִׁשִּׁי	shishi
שִׁשִּׁים	sisim
שֵׁשׁ עֶשְׂרֵה	shesh esre
שָׁת	shat
שֵׁת	shet
שָׁתָה	shata
שְׁתִיָּה	shtiya
שְׁתַּיִם	shtayim
שְׁתֵּים עֶשְׂרֵה	shteyim esre
שֶׁתֶן	sheten
שׁ־ת־ן	sh-t-n
שָׁתַק	shataq
שִׁתֵּק	shiteq
שֻׁתַּק	shutaq
תָּא	ta
תֵּאָבוֹן	teavon
תָּא־גָּז	ta-gaz
תָּא־גָּזִים	ta-gazim
תְּאוֹם	tom
תְּאוּצָה	teutsa
תֵּאוּר	teur
תָּאֵי	taey
תָּאִי	tai
תָּאִים	taim
תָּאִית	tait
תֹּאמַר	tomar
תֹּאמַרְןָ	tomarna
תֹאמְרֻן	tomrun
תְּאֵנָה	teina
תֵּאֵר	teer
תֹּאַר	toar
תֹּאַר	toar
תַּאֲרִיךְ	taarikh
תאריך פג תוקף	taarikh peg tokef
תָּבֹא	tavo
תָּבֹאנָה	tavona
תֵּבָה	teva
תָּבוֹא	tavo
תְּבוּסָה	tvusa
תַּבְלִין	tavlin
תַּבְנִית	tavnit
תֵּבַת דֹּאַר	teyvat doar
תָּג	tag
תְּגוּבָה	tguva
תְּגוּבִית	tguvit
תַּגְלִית	taglit
תְּדַבֵּר	tdaber
תִּדְלֵק	tidlek
תֵּה	te
תֹּהוּ	tohu
תְּהוֹם	thom
תִּהְיֶה	tihye
תְּהִלָּה	thila
תַּהֲלִיךְ	tahalikh
תְּהִלִּים	tehilim
תֵּה מִנְחָה	te minha
תָּו	tav
תּוֹגַרְמָה	togarma
תּוֹדָה	toda
תָּוִית	tavit
תָּוִית יִדּוּעַ	tavit yidua
תָּוֶךְ	tavech
תּוֹלָדָה	tolada
תּוֹלַעַת	tolaat
תּוֹם	tom
תוֹעֵבָה	toeva
תּוֹצָאָה	totsaa
תּוֹר	tor
תּוֹרָה	tora
תּוֹרוֹת	torot
תּוּרְכִּי	turki
תּוּרְכְּיָה	turkya
תּוֹרַת־	torat-
תּוּת	tut
תְּזוּזָה	tzuza
תְּזוּנָה	tzuna
תִּזְמֹרֶת	tizmoret
תַּחְבּוּרָה	takhbura
תַּחְבּוּרָה צִבּוּרִית	takhbura tsiburit
תִּחוּם	tikhum
תְּחוּם	tkhum
תְּחִיָּה	tkhiya
תְּחַיּוּן	tchayun
תְּחַיֶּיןָ	tchayena
תְּחִיַּת הַמֵּתִים	tkhiyat hametim
תְּחִלָּה	thila
תָּחַם	takham
תַּחְמֹשֶׁת	takhmoshet
תַּחֲנָה	takhana
תַּחֲנַת־	tachanat-
תַּחֲנַת אוֹטוֹבּוּס	takhanat otobus
תַּחֲנַת רַכֶּבֶת	takhanat rakevet
תַּחְפֹּשֶׂת	takhposet
תַּחַת	takhat
תַּחְתּוֹנִים	takhtonim
תֵּיבוֹת	tevot
תִּיכוֹן	tikhon
תַּיְלַנְד	tailand
תַּיְלַנְדִּי	tailandi
תַּיְלַנְדִּית	tailandit
תַּיְלַנְדִּית	tailandit
תֵּימָן	teiman
תִּינוֹק	tinok
תִּינוֹקוֹת	tinokot
תִּינֹקֶת	tinoket
תִּיק	tik
תִּיק גַּב	tik gav
תַיָר	tayar
תִּירֶאןָ	tirena
תִּירָס	tiras
תַּכֶּה	take
תֻּכִּי	tuki
תְּכֵלֶת	tchelet
תׇּכְנָה	tokhna
תִּכְנוּת	tikhnut
תִּכְנֵן	tikhnen
תִּכְנֵת	tikhnet
תֵּל	tel
תָּלוּי	talui
תֵּלְכוּ	telchu
תֵּלֵכוּן	telechun
תֶּלֶם	telem
תַּלְמוּד	talmud
תַּלְמִיד	talmid
תַּלְמִידָה	talmida
תְּלַת	tlat-
תַּלְתַּל	taltal
תִּלְתֵּל	tiltel
תִּלְתָּן	tiltan
תַּם	tam
תָּם	tam
תֹּם	tom
תֹּם	tom
תַּמָּה	tama
תָּמַהּ	tamah
תָּמֵהַּ	tameah
תֶּמָה	tema
תֵּמַהּ	temah
תַּמּוּז	tamuz
תְּמוּנָה	tmuna
תָּמִיד	tamid
תְּמִידִי	tmidi
תָּמִים	tamim
תְּמִימוּת	tmimut
תִּמָּלֵא	timale
תִּמְלָא	timla
תְּמַלֵּא	tmale
תָּמָר	tamar
תַּן	tan
תֵּן	ten
תַּנָּא	tana
תְּנַאי	tnai
תְּנוּחָה	tnukha
תְּנוּעָה	tnua
תנועות	tnuot
תַּנִּים	tanim
תִּנְשֶׁמֶת	tinshemet
תָּסִיל	tasil
תִּסְפֹּרֶת	tisporet
תִּסְרֹקֶת	tisroket
תִּעֵב	tiev
תַּעַבְדוּן	taavdun
תְעוּפָה	tufa
תַּעֲנִית	taanit
תַּעֲרוּכָה	taarukha
תַּעֲרוּכָה עוֹלָמִית	taarukha olamit
תַּעֲשֶׂה	taase
תֵּעָשֶׂה	tease
תַּעֲשׂוּ	taasu
תַּעֲשׂוּן	taasun
תֹּף	tof
תִּפְאֶרֶת	tiferet
תַּפּוּז	tapuz
תַּפּוּחַ	tapuakh
תַּפּוּחֵי	tapuche
תַּפּוּחִים	tapukhim
תַּפּוּחֵי עֵץ	tapuche etz
תֻּפִּים	tupim
תְּפִיסָה	tfisa
תְּפִירָה	tfira
תְּפִישָׂה	tfisa
תָּפֵל	tafel
תְּפִלָּה	tfila
תָּפַס	tafas
תִּפְקֵד	tifked
תַּפְקִיד	tafqid
תָּפַר	tafar
תַּפְרִיט	tafrit
תַּצְלוּם	tatslum
תַּצְלִיל	tatzlil
תִּקְוָה	tikva
תְּקוּפָה	tkufa
תְּקוּפוֹת	tkufot
תְּקוּפַת	tkufat
תִּקַּח	tikach
תקטולת	tiktolet, tiqtolet
תְּקִיעָה	tkia
תַּקָּלָה	taqala
תָּקַע	taka
תֶּקַע	teka
תַּקְצִיב	taktsiv
תַּקְרֶאנָה	takrena
תִּקְרֶאנָה	tikrena
תַּקְרִב	takriv
תִּקְרַב	tikrav
תִּקְרָה	tikra
תִּקְשֹׁרֶת	tikshoret
תָּר	tar
תַּרְבּוּת	tarbut
תַּרְגּוּם	targum
תִּרְגּוּם	tirgum
תַּרְגִּיל	targil
תִּרְגֵּל	tirgel
תִּרְגֵּם	tirgem
תֻּרְגְּמָן	turgman
תִּרְגֹּמֶת	tirgomet
תַּרְדֵּמָה	tardema
תְּרוּעָה	trua
תְּרוּפָה	trufa
תֶּרַח	terah
תְּרִיס	tris
תְּרֵיסָר	tresar
תָּרַם	taram
תַּרְנְגוֹל	tarnegol
תַּרְנְגֹלֶת	tarnegolet
תַּרְנְהוֹד	tarnhod
תְּרָפִים	trafim
תַּשְׁבֵּץ	tashbets
תַּשְׁדִּיר	tashdir
תַּשְׁדִּיר־שֵׁרוּת	tashdir-sherut
תְּשׂוּאָה	tsua
תְּשׂואוֹת	tsuot
תְּשׁוּבָה	tshuva
תְּשׁוּבוֹת	tshuvot
תְּשׁוּבַת־	tshuvat
תְּשׁוּקָה	teshuqah
תַּשְׁחֵץ	tashkhets
תְּשִׁיעִי	tshii
תַּשְׁלוּם	tashlum
תַּשְׁלִיךְ	tashlich
תַּשְׁלִיכֻהוּ	tashlichuhu
תֵּשַׁע	teisha
תִּשְׁעָה	tisha
תִּשְׁעִים	tishim
תִּשְׁרֵי	tishrei
תִּתְקַדֵּם	titkadem
תַּתְרָן	tatran
תַּתְרָנִית	tatranit
